§^^^^^^^^^^^^^^^^^^^^^^^^^^^^^^^^^^^^^^$§^^^^^^^^^^^^^^^^^^^^^^^^^^^^^$
[¤¤¤¤¤¤¤¤¤¤¤¤¤¤¤¤¤¤¤¤¤¤¤¤¤¤¤¤¤¤¤¤¤¤¤¤¤¤][¤¤¤¤¤¤¤¤¤¤¤¤¤¤¤¤¤¤¤¤¤¤¤¤¤¤¤¤¤]
[¤¤¤¤¤¤¤¤¤¤¤¤¤¤¤¤¤¤¤¤¤¤¤¤¤¤¤¤¤¤¤¤¤¤¤¤¤¤][¤¤¤¤¤¤¤¤¤¤¤¤¤¤¤¤¤¤¤¤¤¤¤¤¤¤¤¤¤]
[¤¤¤¤¤¤¤¤¤¤¤¤¤¤¤¤¤¤¤¤¤¤¤¤¤¤¤¤¤¤¤¤¤¤¤¤¤¤][¤¤¤¤¤¤¤¤¤¤¤¤¤¤¤¤¤¤¤¤¤¤¤¤¤¤¤¤¤]
[¤¤¤¤¤¤¤¤¤¤¤¤¤¤¤¤¤¤¤¤¤¤¤¤¤¤¤¤¤¤¤¤¤¤¤¤¤¤][¤¤¤¤¤¤¤¤¤¤¤¤¤¤¤¤¤¤¤¤¤¤¤¤¤¤¤¤¤]
%°°°°°°°°°°°°°°°°°°°$¤¤¤¤¤¤§$¤¤¤¤¤¤¤¤¤¤][¤¤¤¤¤¤¤¤¤¤¤¤¤¤¤¤¤¤¤¤¤¤¤¤¤¤¤¤¤]
§^^^^^^^^^^^^^^^^^^$[¤¤¤¤¤¤][¤¤¤¤¤¤¤¤¤¤][¤¤¤¤§$¤¤¤¤¤§°°°°°°°°°°°°°°°°°&
[¤¤¤¤¤¤¤¤¤¤¤¤¤¤¤¤¤¤][¤¤¤¤¤¤][¤¤¤¤¤¤¤¤¤¤][¤¤¤¤][¤¤¤¤¤]§^^^^^^^^^^^^^^^^$
[¤¤¤¤¤¤¤¤¤¤¤¤¤¤¤¤¤¤][¤¤¤¤¤¤][¤¤¤¤¤¤¤¤¤¤][¤¤¤¤][¤¤¤¤¤][¤¤¤¤¤¤¤¤¤¤¤¤¤¤¤¤]
[¤¤¤¤¤¤¤¤¤¤¤¤¤¤¤¤¤¤][¤¤¤¤¤¤][¤¤¤¤¤¤¤¤¤¤][¤¤¤¤][¤¤¤¤¤][¤¤¤¤¤¤¤¤¤¤¤¤¤¤¤¤]
[¤¤¤¤¤¤§$¤¤¤¤¤¤¤¤¤¤][¤¤¤¤¤¤][¤¤¤¤¤¤¤¤¤¤][¤¤¤¤][¤¤¤¤¤][¤¤¤¤¤¤¤¤¤¤¤¤¤¤¤¤]
[¤¤¤¤¤¤][¤¤¤¤¤¤¤¤¤¤][¤¤¤¤¤¤][¤¤¤¤¤¤¤¤¤¤][¤¤¤¤][¤¤¤¤¤][¤¤¤¤¤¤¤§$¤¤¤¤¤¤¤]
[¤¤¤¤¤¤][¤¤¤¤¤¤¤¤¤¤][¤¤¤¤¤¤][¤¤¤¤¤¤¤¤¤¤][¤¤¤¤][¤¤¤¤¤][¤¤¤¤¤¤¤][¤¤¤¤¤¤¤]
[¤¤¤¤¤¤][¤¤¤¤¤¤¤¤¤¤][¤¤¤¤¤¤]%°°°°°°°°°°&[¤¤¤¤][¤¤¤¤¤][¤¤¤¤¤¤¤][¤¤¤¤¤¤¤]
[¤¤¤¤¤¤][¤¤¤¤¤¤¤¤¤¤%&¤¤¤¤¤¤%^^^^^^^^^^^^&¤¤¤¤][¤¤¤¤¤][¤¤¤¤¤¤¤][¤¤¤¤¤¤¤]
[¤¤¤¤¤¤][¤¤¤¤¤¤¤¤¤¤¤¤¤¤¤¤¤¤¤¤¤¤¤¤¤¤¤¤¤¤¤¤¤¤¤¤][¤¤¤¤¤][¤¤¤¤¤¤¤][¤¤¤¤¤¤¤]
[¤¤¤¤¤¤][¤¤¤¤¤¤¤¤¤¤¤¤¤¤¤¤¤¤¤¤¤¤¤¤¤¤¤¤¤¤¤¤¤¤¤¤][¤¤¤¤¤][¤¤¤¤¤¤¤][¤¤¤¤¤¤¤]
[¤¤¤¤¤¤][¤¤¤¤¤¤¤¤¤¤¤¤¤¤¤¤¤¤¤¤¤¤¤¤¤¤¤¤¤¤¤¤¤¤¤¤%&¤¤¤¤¤%&¤¤¤¤¤¤¤%&¤¤¤¤¤¤¤]
[¤¤¤¤¤¤]%°°°°°°°°°°$¤¤¤¤¤¤¤¤¤§°°°°°°°°°°$¤¤¤¤¤¤¤¤¤¤¤¤¤¤¤¤¤¤¤¤¤¤¤¤¤¤¤¤¤]
[¤¤¤¤¤¤%^^^^^^^^^^^&¤¤¤¤¤¤¤¤¤]§^^^^^^^^$[¤¤¤¤¤¤¤¤¤¤¤¤¤¤¤¤¤¤¤¤¤¤¤¤¤¤¤¤¤]
[¤¤¤¤¤¤¤¤¤¤¤¤¤¤¤¤¤¤¤¤¤¤¤¤¤¤¤¤][¤¤¤¤¤¤¤¤][¤¤¤¤¤¤¤¤¤¤¤¤¤¤¤¤¤¤¤¤¤¤¤¤¤¤¤¤¤]
[¤¤¤¤¤¤¤¤¤¤¤¤¤¤¤¤¤¤¤¤¤¤¤¤¤¤¤¤][¤¤¤¤¤¤¤¤]%°°°°°°°°°°°°°°°°°°°°°°°°°°°°°&
[¤¤¤¤¤¤¤¤¤¤¤¤¤¤¤¤¤¤¤¤¤¤¤¤¤¤¤¤][¤¤¤¤T¤¤¤]§^^^^^^^^^^^^^^^^^^^^^^^^^^^^^$
[¤¤¤¤¤¤¤¤¤¤¤¤¤¤¤¤¤¤¤¤¤¤¤¤¤¤¤¤][¤¤¤¤¤¤¤¤][¤¤¤¤¤¤¤¤¤¤¤¤¤¤¤¤¤¤¤¤¤¤¤¤¤¤¤¤¤]
[¤¤¤¤¤¤¤¤¤¤¤¤¤¤¤¤¤¤¤¤¤¤¤¤¤¤¤¤][¤¤¤¤¤¤¤¤][¤¤¤¤¤¤¤¤¤¤¤¤¤¤¤¤¤¤¤¤¤¤¤¤¤¤¤¤¤]
[¤¤¤¤¤¤§°°°°°°°°°°°$¤¤¤¤¤¤¤¤¤][¤¤¤¤¤¤¤¤][¤¤¤¤¤¤¤¤¤¤¤¤¤¤¤¤¤¤¤¤¤¤¤¤¤¤¤¤¤]
[¤¤¤¤¤¤]§^^^^^^^^^^&¤¤¤¤¤¤¤¤¤][¤¤¤¤¤¤¤¤][¤¤¤¤¤¤¤¤¤¤¤¤¤¤¤¤¤¤¤¤¤¤¤¤¤¤¤¤¤]
[¤¤¤¤¤¤][¤¤¤¤¤¤¤¤¤¤¤¤¤¤¤¤¤¤¤¤][¤¤¤¤¤¤¤¤][¤¤¤¤¤¤¤¤¤¤¤¤¤¤¤¤¤¤¤¤¤¤¤¤¤¤¤¤¤]
[¤¤¤¤¤¤][¤¤¤¤¤¤¤¤¤¤¤¤¤¤¤¤¤¤¤¤][¤¤¤¤¤¤¤¤][¤¤¤¤¤¤¤§°°°°°°°°°°°°$¤¤¤¤¤¤¤¤]
[¤¤¤¤¤¤][¤¤¤¤¤¤¤¤¤¤¤¤¤¤¤¤¤¤¤¤][¤¤¤¤¤¤¤¤][¤¤¤¤¤¤¤]§^^^^^^^^^^$[¤¤¤¤¤¤¤¤]
[¤¤¤¤¤¤]%°°°°°°°°°°°°$¤¤¤¤¤¤¤]%°$¤¤¤¤§°&[¤¤¤¤¤¤¤][¤¤¤¤¤¤¤¤¤¤][¤¤¤¤¤¤¤¤]
[¤¤¤¤¤¤%^^^^^^^^^^^^$[¤¤¤¤¤¤¤%^^&¤¤¤¤%^^&¤¤¤¤¤¤¤][¤¤¤¤¤¤¤¤¤¤][¤¤¤¤¤¤¤¤]
[¤¤¤¤¤¤¤¤¤¤¤¤¤¤¤¤¤¤¤][¤¤¤¤¤¤¤¤¤¤¤¤¤¤¤¤¤¤¤¤¤¤¤¤¤¤][¤¤¤¤¤¤¤¤¤¤][¤¤¤¤¤¤¤¤]
[¤¤¤¤¤¤¤¤¤¤¤¤¤¤¤¤¤¤¤][¤¤¤¤¤¤¤¤¤¤¤¤¤¤¤¤¤¤¤¤¤¤¤¤¤¤][¤¤¤¤¤¤¤¤¤¤][¤¤¤¤¤¤¤¤]
[¤¤¤¤¤¤¤¤§$¤¤¤¤¤¤¤¤¤][¤¤¤¤¤¤¤¤¤¤¤¤¤¤§°°°°°°°°°°°&[¤¤¤¤¤¤¤¤¤¤][¤¤¤¤¤¤¤¤]
[¤¤¤¤¤¤¤¤][¤¤¤¤¤¤¤¤¤][¤¤¤¤¤¤¤¤¤¤¤¤¤¤%^^^^^^^^^^^^&¤¤¤¤¤¤¤¤¤¤][¤¤¤¤¤¤¤¤]
[¤¤¤¤¤¤¤¤][¤¤¤¤¤¤¤¤¤][¤¤¤¤¤¤¤¤¤¤¤¤¤¤¤¤¤¤¤¤¤¤¤¤¤¤¤¤¤¤¤¤¤¤¤¤¤¤][¤¤¤¤¤¤¤¤]
[¤¤¤¤¤¤¤¤][¤¤¤¤¤¤¤¤¤][¤¤¤¤¤¤¤¤¤¤¤¤¤¤¤¤¤¤¤¤¤¤¤¤¤¤¤¤¤¤¤¤¤¤¤¤¤¤][¤¤¤¤¤¤¤¤]
%°°°°°°°°&%°°°°°°°°°&%°°°°°°°°°°°°°°°°°°°°°°°°°°°°°°°°°°°°°°&%°°°°°°°°&
