§^^^^^^^^^^^^^^^^^^^^^^^^^^^^^^^^^^^^^^^^^^^^^^^^^^$^^^^^^^^§$^^^^^^^^$
[¤¤¤¤¤¤¤¤¤¤¤¤¤¤¤¤¤¤¤¤¤¤¤¤¤¤¤¤¤¤¤¤¤¤¤¤¤¤¤¤¤¤¤¤¤¤¤¤¤¤][¤¤¤¤¤¤¤][¤¤¤¤¤¤¤¤]
[¤¤¤¤¤¤¤¤¤¤¤¤¤¤¤¤¤¤¤¤¤¤¤¤¤¤¤¤¤¤¤¤¤¤¤¤¤¤¤¤¤¤¤¤¤¤¤¤¤¤][¤¤¤¤¤¤¤][¤¤¤¤¤¤¤¤]
[¤¤¤¤¤¤¤¤¤¤§°°°°°°°°°°°°°°°°°°°°°°°°°°°°°°°°°°°°°°°&[¤¤¤¤¤¤¤][¤¤¤¤¤¤¤¤]
[¤¤¤¤¤¤¤¤¤¤]§^^^^^^^^^^^^^^^^^^^^^^^^^^^^^^^^^^^^^^^&¤¤¤¤¤¤¤][¤¤¤¤¤¤¤¤]
[¤¤¤¤¤¤¤¤¤¤][¤¤¤¤¤¤¤¤¤¤¤¤¤¤¤¤¤¤¤¤¤¤¤¤¤¤¤¤¤¤¤¤¤¤¤¤¤¤¤¤¤¤¤¤¤¤¤][¤¤¤¤¤¤¤¤]
[¤¤¤¤¤¤¤¤¤¤][¤¤¤¤¤¤¤¤¤¤¤¤¤¤¤¤¤¤¤¤¤¤¤¤¤¤¤¤¤¤¤¤¤¤¤¤¤¤¤¤¤¤¤¤¤¤¤][¤¤¤¤¤¤¤¤]
[¤¤¤¤¤¤¤¤¤¤][¤¤¤¤¤¤¤¤¤¤¤¤¤¤¤¤¤¤¤¤¤¤¤¤¤¤¤¤¤¤¤¤¤¤¤¤¤¤¤¤¤¤¤¤¤¤¤%&¤¤¤¤¤¤¤¤]
[¤¤¤¤¤¤¤¤¤¤][¤¤¤¤¤¤¤¤¤¤¤¤¤¤¤¤¤¤¤¤¤¤¤¤¤¤¤¤¤¤¤¤¤¤¤¤¤¤¤¤¤¤¤¤¤¤¤¤¤¤¤¤¤¤¤¤¤]
[¤¤¤¤¤¤¤¤¤¤][¤¤¤¤¤¤¤¤¤¤¤¤¤¤¤¤¤¤¤¤¤¤¤¤¤¤¤¤¤¤¤¤¤¤¤¤¤¤¤¤¤¤¤¤¤¤¤¤¤¤¤¤¤¤¤¤¤]
[¤¤¤¤¤¤¤¤¤¤][¤¤¤¤¤§°°°°°°°°°°°°°°$¤¤¤¤¤¤¤¤§°°°°°°°°°°°°°°°°°°°°°°°°°°°&
[¤¤¤¤¤¤¤¤¤¤][¤¤¤¤¤%^^^^^^^^^^^^^^&¤¤¤¤¤¤¤¤]§^^^^^^^^^^^^^^^^^^^^^^^^^^$
[¤¤¤¤¤¤¤¤¤¤][¤¤¤¤¤¤¤¤¤¤¤¤¤¤¤¤¤¤¤¤¤¤¤¤¤¤¤¤¤][¤¤¤¤¤¤¤¤¤¤¤¤¤¤¤¤¤¤¤¤¤¤¤¤¤¤]
[¤¤¤¤¤¤¤¤¤¤][¤¤¤¤¤¤¤¤¤¤¤¤¤¤¤¤¤¤¤¤¤¤¤¤¤¤¤¤¤][¤¤¤¤¤¤¤¤¤¤¤¤¤¤¤¤¤¤¤T¤¤¤¤¤¤]
[¤¤¤¤¤¤¤¤¤¤][¤¤¤¤¤¤¤¤¤¤¤¤¤¤¤¤¤¤¤¤¤¤¤¤¤¤¤¤¤][¤¤¤¤¤¤¤¤¤¤¤¤¤¤¤¤¤¤¤¤¤¤¤¤¤¤]
[¤¤¤¤¤¤¤¤¤¤]%°°°°°°°°°°°°°$¤¤§°°°°°°°°°°°°&[¤¤¤¤¤¤¤¤¤¤¤¤¤¤¤¤¤¤¤¤¤¤¤¤¤¤]
[¤¤¤¤¤¤¤¤¤¤%^^^^^^^^^^^^^^&¤¤%^^^^^^^^^^^^^&¤¤¤¤¤¤¤¤¤§°°°°°°°°°°°°°°°°&
[¤¤¤¤¤¤¤¤¤¤¤¤¤¤¤¤¤¤¤¤¤¤¤¤¤¤¤¤¤¤¤¤¤¤¤¤¤¤¤¤¤¤¤¤¤¤¤¤¤¤¤¤]§^^^^^^^^^^^^^^^$
[¤¤¤¤¤¤¤¤¤¤¤¤¤¤¤¤¤¤¤¤¤¤¤¤¤¤¤¤¤¤¤¤¤¤¤¤¤¤¤¤¤¤¤¤¤¤¤¤¤¤¤¤][¤¤¤¤¤¤¤¤¤¤¤¤¤¤¤]
[¤¤¤¤¤¤¤¤¤¤¤¤¤¤¤¤¤¤¤¤¤¤¤¤¤¤¤¤¤¤¤¤¤¤¤¤¤¤¤¤¤¤¤¤¤¤¤¤¤¤¤¤][¤¤¤¤¤¤¤¤¤¤¤¤¤¤¤]
[¤¤¤¤¤¤¤¤¤$°°°°°°°°°°°°°°°°°°°°°°°°°°°°°°°°°°°°°°°°°°&[¤¤¤¤¤¤¤¤¤¤¤¤¤¤¤]
[¤¤¤¤¤¤¤¤¤]$^^^^^^^^^^^^^^^^^^^^^^^^^^^^^^^^^^^^^^^^^^&¤¤¤¤¤¤¤¤¤¤¤¤¤¤¤]
[¤¤¤¤¤¤¤¤¤][¤¤¤¤¤¤¤¤¤¤¤¤¤¤¤¤¤¤¤¤¤¤¤¤¤¤¤¤¤¤¤¤¤¤¤¤¤¤¤¤¤¤¤¤¤¤¤¤][¤¤¤¤¤¤¤¤]
[¤¤¤¤¤¤¤¤¤][¤¤¤¤¤¤¤¤¤¤¤¤¤¤¤¤¤¤¤¤¤¤¤¤¤¤¤¤¤¤¤¤¤¤¤¤¤¤¤¤¤¤¤¤¤¤¤¤][¤¤¤¤¤¤¤¤]
[¤¤¤¤¤¤¤¤¤][¤¤¤¤§$¤¤¤¤¤¤¤¤¤¤¤¤¤¤¤¤¤¤¤¤¤¤¤¤¤¤¤¤¤¤¤¤¤¤¤¤¤¤¤¤¤¤][¤¤¤¤¤¤¤¤]
[¤¤¤¤¤¤¤¤¤][¤¤¤¤][¤¤¤¤¤¤§°°°°°°°°°°°°°°°°°°°°°°°°°°°°°°°°°°°&[¤¤¤¤¤¤¤¤]
[¤¤¤¤¤¤¤¤¤][¤¤¤¤][¤¤¤¤¤¤]§^^^^^^^^^^^^^^^^^^^^^^^^^^^^^^^^^^^&¤¤¤¤¤¤¤¤]
[¤¤¤¤¤¤¤¤¤][¤¤¤¤][¤¤¤¤¤¤][¤¤¤¤¤¤¤¤¤¤¤¤¤¤¤¤¤¤¤¤¤¤¤¤¤¤¤¤¤¤¤¤¤¤¤¤¤¤¤¤¤¤¤¤]
[¤¤¤¤¤¤¤¤¤][¤¤¤¤][¤¤¤¤¤¤][¤¤¤¤¤¤¤¤¤¤¤¤¤¤¤¤¤¤¤¤¤¤¤¤¤¤¤¤¤¤¤¤¤¤¤¤¤¤¤¤¤¤¤¤]
[¤¤¤¤¤¤¤¤¤][¤¤¤¤][¤¤¤¤¤¤][¤¤¤¤¤¤¤¤¤¤¤¤¤¤¤¤¤¤¤¤¤¤¤¤¤¤¤¤¤¤¤¤¤¤§$¤¤¤¤¤¤¤¤]
[¤¤¤¤¤¤¤¤¤][¤¤¤¤][¤¤¤¤¤¤][¤¤¤¤¤¤¤¤¤¤¤¤¤¤¤¤¤¤¤¤¤¤¤¤¤¤¤¤¤¤¤¤¤¤][¤¤¤¤¤¤¤¤]
[¤¤¤¤¤¤¤¤¤][¤¤¤¤][¤¤¤¤¤¤][¤¤¤¤¤¤¤¤¤¤¤¤¤¤¤¤¤¤¤¤¤¤¤¤¤¤¤¤¤¤¤¤¤¤][¤¤¤¤¤¤¤¤]
[¤¤¤¤¤¤¤¤¤][¤¤¤¤][¤¤¤¤¤¤][¤¤¤¤¤¤¤¤¤¤§°°°°°°°°°°°°°°°°°°°°°°°&[¤¤¤¤¤¤¤¤]
[¤¤¤¤¤¤¤¤¤][¤¤¤¤][¤¤¤¤¤¤][¤¤¤¤¤¤¤¤¤¤]§^^^^^^^^^^^^^^^^^^^^^^^&¤¤¤¤¤¤¤¤]
[¤¤¤¤¤¤¤¤¤][¤¤¤¤][¤¤¤¤¤¤][¤¤¤¤¤¤¤¤¤¤][¤¤¤¤¤¤¤¤¤¤¤¤¤¤¤¤¤¤¤¤¤¤¤¤¤¤¤¤¤¤¤¤]
[¤¤¤¤¤¤¤¤¤][¤¤¤¤][¤¤¤¤¤¤][¤¤¤¤¤¤¤¤¤¤][¤¤¤¤¤¤¤¤¤¤¤¤¤¤¤¤¤¤¤¤¤¤¤¤¤¤¤¤¤¤¤¤]
[¤¤¤¤¤¤¤¤¤%&¤¤¤¤][¤¤¤¤¤¤%&¤¤¤¤¤¤¤¤¤¤][¤¤¤¤¤¤¤¤¤¤¤¤¤¤¤¤¤¤¤¤¤¤¤¤¤¤¤¤¤¤¤¤]
[¤¤¤¤¤¤¤¤¤¤¤¤¤¤¤%&¤¤¤¤¤¤¤¤¤¤¤¤¤¤¤¤¤¤][¤¤¤¤¤¤¤¤¤¤¤¤¤¤¤¤¤¤¤¤¤¤¤¤¤¤¤¤¤¤¤¤]
[¤¤¤¤¤¤¤¤¤¤¤¤¤¤¤¤¤¤¤¤¤¤¤¤¤¤¤¤¤¤¤¤¤¤¤][¤¤¤¤¤¤¤¤¤¤¤¤¤¤¤¤¤¤¤¤¤¤¤¤¤¤¤¤¤¤¤¤]
%°°°°°°°°°°°°°°°°°°°°°°°°°°°°°°°°°°°&%°°°°°°°°°°°°°°°°°°°°°°°°°°°°°°°°&
