§^^^^^^^^^^^^^^^^^^^^^^^^^^^^^^^^^^^^^^$§^^^^^^^^^^^^^^^^^^^^^^^^^^^^^$
[¤¤¤¤¤¤¤¤¤¤¤¤¤¤¤¤¤¤¤¤¤¤¤¤¤¤¤¤¤¤¤¤¤¤¤¤¤¤][¤¤¤¤¤¤¤¤¤¤¤¤¤¤¤¤¤¤¤¤¤¤¤¤¤¤¤¤¤]
[¤¤¤¤¤¤¤¤¤¤¤¤¤¤¤¤¤¤¤¤¤¤¤¤¤¤¤¤¤¤¤¤¤¤¤¤¤¤][¤¤¤¤¤¤¤¤¤¤¤¤¤¤¤¤¤¤¤¤¤¤¤¤¤¤¤¤¤]
[¤¤¤¤¤¤§°°°°°°°°°°°°°°°°°°°°°°°°°°°°°°°&[¤¤¤¤¤¤¤¤¤¤¤¤¤¤¤¤¤¤¤¤¤¤¤¤¤¤¤¤¤]
[¤¤¤¤¤¤]§^^^^^^^^^^^^^^^^^^^^^^^^^^^^^^$%°°°°°°°°°°°°°°°°°°°°°°$¤¤¤¤¤¤]
[¤¤¤¤¤¤][¤¤¤¤¤¤¤¤¤¤¤¤¤¤¤¤¤¤¤¤¤¤¤¤¤¤¤¤¤¤]§^^^^^^^^^^^^^^^^^^^^^$[¤¤¤¤¤¤]
[¤¤¤¤¤¤][¤¤¤¤¤¤¤¤¤¤¤¤¤¤¤¤¤¤¤¤¤¤¤¤¤¤¤¤¤¤][¤¤¤¤¤¤¤¤¤¤¤¤¤¤¤¤¤¤¤¤¤][¤¤¤¤¤¤]
[¤¤¤¤¤¤][¤¤¤¤¤¤¤¤¤¤¤¤¤¤¤¤¤¤¤¤¤¤¤¤¤¤¤¤¤¤][¤¤¤¤¤¤¤¤¤¤¤¤¤¤¤¤¤¤¤¤¤][¤¤¤¤¤¤]
[¤¤¤¤¤¤][¤¤¤¤¤¤¤¤¤¤¤¤¤¤¤¤¤¤¤¤¤¤¤¤¤¤¤¤¤¤][¤¤¤¤¤¤¤¤¤§$¤¤¤¤¤¤¤¤¤¤][¤¤¤¤¤¤]
[¤¤¤¤¤¤][¤¤¤¤¤¤¤¤¤¤¤¤¤¤¤¤¤¤¤¤¤¤¤¤¤¤¤¤¤¤][¤¤¤¤¤¤¤¤¤][¤¤¤¤¤¤¤¤¤¤][¤¤¤¤¤¤]
[¤¤¤¤¤¤]%°°°°°°°°°°°°°°°°°°°°°°$¤¤¤¤¤¤¤][¤¤¤¤¤¤¤¤¤][¤¤¤¤¤¤¤¤¤¤][¤¤¤¤¤¤]
[¤¤¤¤¤¤%^^^^^^^^^^^^^^^^^^^^^^^&¤¤¤¤¤¤¤][¤¤¤¤¤¤¤¤¤][¤¤¤¤¤¤¤¤¤¤][¤¤¤¤¤¤]
[¤¤¤¤¤¤¤¤¤¤¤¤¤¤¤¤¤¤¤¤¤¤¤¤¤¤¤¤¤¤¤¤¤¤¤¤¤¤][¤¤¤¤¤¤¤¤¤][¤¤¤¤¤¤¤¤¤¤%&¤¤¤¤¤¤]
[¤¤¤¤¤¤¤¤¤¤¤¤¤¤¤¤¤¤¤¤¤¤¤¤¤¤¤¤¤¤¤¤¤¤¤¤¤¤][¤¤¤¤¤¤¤¤¤%&¤¤¤¤¤¤¤¤¤¤¤¤¤¤¤¤¤¤]
[¤¤¤¤¤¤§°°°°°°°°°°°°°°°°°°°°°°°°°°°°°°°$[¤¤¤¤¤¤¤¤¤¤¤¤¤¤¤¤¤¤¤¤¤¤¤¤¤¤¤¤¤]
[¤¤¤¤¤¤]§^^^^^^^^^^^^^^^^^^^^^^^^^^^^^^^$¤¤¤¤¤¤¤¤¤¤¤¤¤¤¤¤¤¤¤¤¤¤¤¤¤¤¤¤¤]
[¤¤¤¤¤¤][¤¤¤¤¤¤¤¤¤¤¤¤¤¤¤¤¤¤¤¤¤¤¤¤¤¤¤¤¤¤¤¤¤¤¤¤¤¤¤¤¤¤¤¤¤¤¤¤¤¤¤¤¤¤¤¤¤¤¤¤¤]
[¤¤¤¤¤¤][¤¤¤¤¤¤¤¤¤¤¤¤¤¤¤¤¤¤¤¤¤¤¤¤¤¤¤¤¤¤¤¤¤¤¤¤¤¤¤¤¤§°°°°°°°°°°°°°°°°°°°&
[¤¤¤¤¤¤][¤¤¤¤¤¤¤¤¤¤¤¤¤¤¤¤¤¤¤¤¤¤¤¤¤¤¤¤¤¤¤¤¤¤¤¤¤¤¤¤¤%^^^^^^^^^^^^^^^^^^^$
[¤¤¤¤¤¤][¤¤¤¤¤¤¤¤§°°°°°°°°°°°°°°°°°°°°°°$¤¤¤¤¤¤¤¤¤¤¤¤¤¤¤¤¤¤¤¤¤¤¤¤¤¤¤¤¤]
[¤¤¤¤¤¤%&¤¤¤¤¤¤¤¤%^^^^^^^^^^^^^^^^^^^^^^&¤¤¤¤¤¤¤¤¤¤¤¤¤¤¤¤¤¤¤¤¤¤¤¤¤¤¤¤¤]
[¤¤¤¤¤¤¤¤¤¤¤¤¤¤¤¤¤¤¤¤¤¤¤¤¤¤¤¤¤¤¤¤¤¤¤¤¤¤¤¤¤¤¤¤¤¤¤¤¤¤¤¤¤¤¤¤¤¤¤¤¤¤¤¤¤¤¤¤¤]
[¤¤¤¤¤¤¤¤¤¤¤¤¤¤¤¤¤¤¤¤¤¤¤¤¤¤¤¤¤¤¤¤¤¤¤¤¤¤¤¤¤¤¤¤¤¤¤¤¤¤¤¤¤¤¤¤¤¤¤¤¤¤¤¤¤¤¤¤¤]
%°°°°°°°°°°°°°°°°°°°°°°°°°°°°°°°°°°$¤¤¤¤¤¤¤¤¤¤¤¤¤¤¤¤§$¤¤¤¤¤¤¤¤¤¤¤¤¤¤¤¤]
§^^^^^^^^^^^^^^^^^^^^^^^^^^^^^^^^^$[¤¤¤¤¤¤¤¤¤¤¤¤¤¤¤¤][¤¤¤¤¤¤¤¤¤¤¤¤¤¤¤¤]
[¤¤¤¤¤¤¤¤¤¤¤¤¤¤¤¤¤¤¤¤¤¤¤¤¤¤¤¤¤¤¤¤¤][¤¤¤¤¤¤¤¤¤¤¤¤¤¤¤¤][¤¤¤¤¤¤¤¤¤¤¤¤¤¤¤¤]
[¤¤¤¤¤¤¤¤¤¤¤¤¤¤¤¤¤¤¤¤¤¤¤¤¤¤¤¤¤¤¤¤¤][¤¤¤¤¤¤¤§$¤¤¤¤¤¤¤][¤¤¤¤¤¤¤¤¤¤¤¤¤¤¤¤]
[¤¤¤¤¤¤¤¤§°°°°°°°°°°°°°°°°°°°$¤¤¤¤][¤¤¤¤¤¤¤][¤¤¤¤¤¤¤][¤¤¤¤¤¤¤¤¤¤¤¤¤¤¤¤]
[¤¤¤¤¤¤¤¤]§^^^^^^^^^^^^^^^^^$[¤¤¤¤][¤¤¤¤¤¤¤][¤¤¤¤¤¤¤][¤¤¤¤¤¤¤¤¤¤¤¤¤¤¤¤]
[¤¤¤¤¤¤¤¤][¤¤¤¤¤¤¤¤¤¤¤¤¤¤¤¤¤][¤¤T¤][¤¤¤¤¤¤¤][¤¤¤¤¤¤¤][¤¤¤¤¤¤¤¤¤¤¤¤¤¤¤¤]
[¤¤¤¤¤¤¤¤][¤¤¤¤¤¤¤¤¤¤¤¤¤¤¤¤¤][¤¤¤¤][¤¤¤¤¤¤¤][¤¤¤¤¤¤¤][¤¤¤¤¤¤¤¤¤¤¤¤¤¤¤¤]
[¤¤¤¤¤¤¤¤][¤¤¤¤¤¤¤¤¤¤¤¤¤¤¤¤¤]%°°°°&[¤¤¤¤¤¤¤][¤¤¤¤¤¤¤][¤¤¤¤¤¤¤¤¤¤¤¤¤¤¤¤]
[¤¤¤¤¤¤¤¤][¤¤¤¤¤¤¤¤¤¤¤¤¤¤¤¤¤%^^^^^^&¤¤¤¤¤¤¤][¤¤¤¤¤¤¤][¤¤¤¤¤¤¤¤¤¤¤¤¤¤¤¤]
[¤¤¤¤¤¤¤¤][¤¤¤¤¤¤¤¤¤¤¤¤¤¤¤¤¤¤¤¤¤¤¤¤¤¤¤¤¤¤¤¤][¤¤¤¤¤¤¤][¤¤¤¤¤¤¤¤¤¤¤¤¤¤¤¤]
[¤¤¤¤¤¤¤¤][¤¤¤¤¤¤¤¤¤¤¤¤¤¤¤¤¤¤¤¤¤¤¤¤¤¤¤¤¤¤¤¤][¤¤¤¤¤¤¤][¤¤¤¤¤¤¤¤¤¤¤¤¤¤¤¤]
[¤¤¤¤¤¤¤¤][¤¤¤¤¤¤¤¤¤¤¤¤¤¤¤¤¤¤¤¤¤¤¤¤¤¤¤¤¤¤¤¤%&¤¤¤¤¤¤¤][¤¤¤¤¤¤¤¤¤¤¤¤¤¤¤¤]
[¤¤¤¤¤¤¤¤%&¤¤¤¤¤¤¤¤¤¤¤¤¤¤¤¤¤§$¤¤¤¤¤¤¤¤¤¤¤¤¤¤¤¤¤¤¤¤¤¤][¤¤¤¤¤¤¤¤¤¤¤¤¤¤¤¤]
[¤¤¤¤¤¤¤¤¤¤¤¤¤¤¤¤¤¤¤¤¤¤¤¤¤¤¤][¤¤¤¤¤¤¤¤¤¤¤¤¤¤¤¤¤¤¤¤¤¤][¤¤¤¤¤¤¤¤¤¤¤¤¤¤¤¤]
[¤¤¤¤¤¤¤¤¤¤¤¤¤¤¤¤¤¤¤¤¤¤¤¤¤¤¤][¤¤¤¤¤¤¤¤¤¤¤¤¤¤¤¤¤¤¤¤¤¤][¤¤¤¤¤¤¤¤¤¤¤¤¤¤¤¤]
%°°°°°°°°°°°°°°°°°°°°°°°°°°°&%°°°°°°°°°°°°°°°°°°°°°°&%°°°°°°°°°°°°°°°°&
