§^^^^^$§^^^^^^^^^^^^^^^^^$§^^^^^^^^^^^^^^^^^^^^^^^^^^^^^^^^^^^^^^^^^^^$
[¤¤¤¤¤][¤¤¤¤¤¤¤¤¤¤¤¤¤¤¤¤¤][¤¤¤¤¤¤¤¤¤¤¤¤¤¤¤¤¤¤¤¤¤¤¤¤¤¤¤¤¤¤¤¤¤¤¤¤¤¤¤¤¤¤¤]
[¤¤¤¤¤][¤¤¤¤¤¤¤¤¤¤¤¤¤¤¤¤¤][¤¤¤¤¤¤¤¤¤¤¤¤¤¤¤¤¤¤¤¤¤¤¤¤¤¤¤¤¤¤¤¤¤¤¤¤¤¤¤¤¤¤¤]
[¤¤¤¤¤][¤¤¤¤¤¤¤¤¤¤¤¤¤¤¤¤¤%&¤¤¤¤¤¤¤¤¤¤¤¤¤¤¤¤¤¤¤¤¤¤¤§°°°°°°°°°°°°°°°°°°°&
[¤¤¤¤¤][¤¤¤¤¤¤¤¤¤¤¤¤¤¤¤¤¤¤¤¤¤¤¤¤¤¤¤¤¤¤¤¤¤¤¤¤¤¤¤¤¤¤]§^^^^^^^^^^^^^^^^^^$
[¤¤¤¤¤][¤¤¤¤¤¤¤¤¤¤¤¤¤¤¤¤¤¤¤¤¤¤¤¤¤¤¤¤¤¤¤¤¤¤¤¤¤¤¤¤¤¤][¤¤¤¤¤¤¤¤¤¤¤¤¤¤¤¤¤¤]
[¤¤¤¤¤]%°°°°°°°°°°°°°°°°°°°°°°°°°°°°°°$¤¤¤¤§°°°°°°&[¤¤¤¤¤¤¤¤¤¤¤¤¤¤¤¤¤¤]
[¤¤¤¤¤%^^^^^^^^^^^^^^^^^^^^^^^^^^^^^^^&¤¤¤¤%^^^^^^$[¤¤¤¤¤¤¤¤¤¤¤¤¤¤¤¤¤¤]
[¤¤¤¤¤¤¤¤¤¤¤¤¤¤¤¤¤¤¤¤¤¤¤¤¤¤¤¤¤¤¤¤¤¤¤¤¤¤¤¤¤¤¤¤¤¤¤¤¤][¤¤¤¤¤¤¤¤§$¤¤¤¤¤¤¤¤]
[¤¤¤¤¤¤¤¤¤¤¤¤¤¤¤¤¤¤¤¤¤¤¤¤¤¤¤¤¤¤¤¤¤¤¤¤¤¤¤¤¤¤¤¤¤¤¤¤¤][¤¤¤¤¤¤¤¤][¤¤¤¤¤¤¤¤]
[¤¤¤¤¤¤¤¤¤¤¤¤¤¤¤¤¤¤¤¤¤¤¤¤¤¤¤¤¤¤¤¤¤¤¤¤¤¤¤¤¤¤¤¤¤¤¤¤¤][¤¤¤¤¤¤¤¤][¤¤¤¤¤¤¤¤]
[¤¤¤¤¤¤¤¤¤¤¤¤¤¤¤¤¤¤¤¤¤¤¤¤¤¤¤¤¤¤¤¤¤¤¤¤¤¤¤¤¤¤¤¤¤¤¤¤¤][¤¤¤¤¤¤¤¤][¤¤¤¤¤¤¤¤]
[¤¤¤¤¤§°°°°°°°°°°°°°°°°°°°°°°°°°°$¤¤¤¤§°°°°°°°°°°°$[¤¤¤¤¤¤¤¤][¤¤¤¤¤¤¤¤]
[¤¤¤¤¤%^^^^^^^^^^^^^^^^^^^^^^^^^$[¤¤¤¤]§^^^^^^^^^^^&¤¤¤¤¤¤¤¤][¤¤¤¤¤¤¤¤]
[¤¤¤¤¤¤¤¤¤¤¤¤¤¤¤¤¤¤¤¤¤¤¤¤¤¤¤¤¤¤¤][¤¤¤¤][¤¤¤¤¤¤¤¤¤¤¤¤¤¤¤¤¤¤¤¤][¤¤¤¤¤¤¤¤]
[¤¤¤¤¤¤¤¤¤¤¤¤¤¤¤¤¤¤¤¤¤¤¤¤¤¤¤¤¤¤¤][¤¤¤¤][¤¤¤¤¤¤¤T¤¤¤¤¤¤¤¤¤¤¤¤][¤¤¤¤¤¤¤¤]
[¤¤¤¤¤¤¤¤¤¤¤¤¤¤¤¤¤¤¤¤¤¤¤¤¤¤¤¤¤¤¤][¤¤¤¤][¤¤¤¤¤¤¤¤¤¤¤¤¤¤¤¤¤¤¤¤][¤¤¤¤¤¤¤¤]
[¤¤¤¤¤§°°°°°°°°°°°°°°°°°°°°$¤¤¤¤][¤¤¤¤]%°°°°°°°°°°°°°°°°°°°°&[¤¤¤¤¤¤¤¤]
[¤¤¤¤¤%^^^^^^^^^^^^^^^^^^^$[¤¤¤¤][¤¤¤¤%^^^^^^^^^^^^^^^^^^^^^^&¤¤¤¤¤¤¤¤]
[¤¤¤¤¤¤¤¤¤¤¤¤¤¤¤¤¤¤¤¤¤¤¤¤¤][¤¤¤¤][¤¤¤¤¤¤¤¤¤¤¤¤¤¤¤¤¤¤¤¤¤¤¤¤¤¤¤¤¤¤¤¤¤¤¤¤]
[¤¤¤¤¤¤¤¤¤¤¤¤¤¤¤¤¤¤¤¤¤¤¤¤¤][¤¤¤¤][¤¤¤¤¤¤¤¤¤¤¤¤¤¤¤¤¤¤¤¤¤¤¤¤¤¤¤¤¤¤¤¤¤¤¤¤]
[¤¤¤¤¤§$¤¤¤¤¤¤¤§$¤¤¤¤¤¤¤¤¤][¤¤¤¤][¤¤¤¤¤¤¤¤¤¤¤¤¤¤¤¤¤¤¤¤¤¤¤¤¤¤¤¤¤¤¤¤¤¤¤¤]
[¤¤¤¤¤][¤¤¤¤¤¤¤][¤¤¤¤¤¤¤¤¤][¤¤¤¤][¤¤¤¤¤¤¤¤¤¤¤¤¤¤¤¤¤¤¤¤¤¤¤¤¤¤¤¤¤¤¤¤¤¤¤¤]
[¤¤¤¤¤][¤¤¤¤¤¤¤][¤¤¤¤¤¤¤¤¤][¤¤¤¤]%°°°°°°°°°°°°°°°°°°°°°°°°°°°$¤¤¤¤¤¤¤¤]
[¤¤¤¤¤][¤¤¤¤¤¤¤][¤¤¤¤§$¤¤¤%&¤¤¤¤%^^^^^^^^^^^^^^^^^^^^^^^^^^^$[¤¤¤¤¤¤¤¤]
[¤¤¤¤¤][¤¤¤¤¤¤¤][¤¤¤¤][¤¤¤¤¤¤¤¤¤¤¤¤¤¤¤¤¤¤¤¤¤¤¤¤¤¤¤¤¤¤¤¤¤¤¤¤¤][¤¤¤¤¤¤¤¤]
[¤¤¤¤¤][¤¤¤¤¤¤¤][¤¤¤¤][¤¤¤¤¤¤¤¤¤¤¤¤¤¤¤¤¤¤¤¤¤¤¤¤¤¤¤¤¤¤¤¤¤¤¤¤¤][¤¤¤¤¤¤¤¤]
[¤¤¤¤¤][¤¤¤¤¤¤¤][¤¤¤¤][¤¤¤¤¤¤¤¤¤¤¤¤¤¤¤¤¤¤¤§$¤¤¤¤¤¤§$¤¤¤¤¤¤¤¤][¤¤¤¤¤¤¤¤]
[¤¤¤¤¤][¤¤¤¤¤¤¤][¤¤¤¤%&¤¤¤¤¤¤¤¤¤¤¤¤¤¤¤¤¤¤¤][¤¤¤¤¤¤][¤¤¤¤¤¤¤¤%&¤¤¤¤¤¤¤¤]
[¤¤¤¤¤][¤¤¤¤¤¤¤][¤¤¤¤¤¤¤¤¤¤¤¤¤¤¤¤¤¤¤¤¤¤¤¤¤][¤¤¤¤¤¤][¤¤¤¤¤¤¤¤¤¤¤¤¤§$¤¤¤]
[¤¤¤¤¤][¤¤¤¤¤¤¤]%°°°°°°°°°°°°°°°°°°°°°°$¤¤][¤¤¤¤¤¤][¤¤¤¤¤¤¤¤¤¤¤¤¤][¤¤¤]
[¤¤¤¤¤][¤¤¤¤¤¤¤%^^^^^^^^^^^^^^^^^^^^^^$[¤¤][¤¤¤¤¤¤][¤¤¤¤¤¤¤¤¤¤¤¤¤][¤¤¤]
[¤¤¤¤¤][¤¤¤¤¤¤¤¤¤¤¤¤¤¤¤¤¤¤¤¤¤¤¤¤¤¤¤¤¤¤][¤¤%&¤¤¤¤¤¤%&¤¤¤¤¤¤¤¤¤¤¤¤¤][¤¤¤]
[¤¤¤¤¤][¤¤¤¤¤¤¤¤¤¤¤¤¤¤¤¤¤¤¤¤¤¤¤¤¤¤¤¤¤¤][¤¤¤¤¤¤¤¤¤¤¤¤¤¤¤¤¤¤¤¤¤¤¤¤¤][¤¤¤]
[¤¤¤¤¤]%°°°°°°°°°°°°$¤¤¤¤¤¤¤¤¤¤¤¤¤¤¤¤¤][¤¤¤¤¤¤¤¤¤¤¤¤¤¤¤¤¤¤¤¤¤¤¤¤¤][¤¤¤]
[¤¤¤¤¤%^^^^^^^^^^^^^&¤¤¤¤¤¤¤¤¤¤¤¤¤¤¤¤¤]%°°°°°°°°°°°°°°°°°°°°°°°°°&[¤¤¤]
[¤¤¤¤¤¤¤¤¤¤¤¤¤¤¤¤¤¤¤¤¤¤¤¤¤¤¤¤¤¤¤¤¤¤¤¤¤%^^^^^^^^^^^^^^^^^^^^^^^^^^^&¤¤¤]
[¤¤¤¤¤¤¤¤¤¤¤¤¤¤¤¤¤¤¤¤¤¤¤¤¤¤¤¤¤¤¤¤¤¤¤¤¤¤¤¤¤¤¤¤¤¤¤¤¤¤¤¤¤¤¤¤¤¤¤¤¤¤¤¤¤¤¤¤¤]
%°°°°°°°°°°°°°°°°°°°°°°°°°°°°°°°°°°°°°°°°°°°°°°°°°°°°°°°°°°°°°°°°°°°°°&
