§^^^^^^^^^^^^^^^^^^^^^^^^^^^^^$§^^^^^^^^^^^^^^^^^^^^^^^^^^^^^^^$§^^^^^$
[¤¤¤¤¤¤¤¤¤¤¤¤¤¤¤¤¤¤¤¤¤¤¤¤¤¤¤¤¤][¤¤¤¤¤¤¤¤¤¤¤¤¤¤¤¤¤¤¤¤¤¤¤¤¤¤¤¤¤¤¤][¤¤T¤¤]
[¤¤¤¤¤¤¤¤¤¤¤¤¤¤¤¤¤¤¤¤¤¤¤¤¤¤¤¤¤][¤¤¤¤¤¤¤¤¤¤¤¤¤¤¤¤¤¤¤¤¤¤¤¤¤¤¤¤¤¤¤%&¤¤¤¤¤]
[¤¤¤¤¤¤¤¤¤¤¤¤¤¤¤¤¤¤¤¤¤¤¤¤¤¤¤¤¤][¤¤¤¤¤¤¤¤¤¤¤¤¤¤¤¤¤¤¤¤¤¤¤¤¤¤¤¤¤¤¤¤¤¤¤¤¤¤]
[¤¤¤¤¤¤¤¤¤¤¤¤¤¤¤¤¤¤¤¤¤¤¤¤¤¤¤¤¤][¤¤¤¤¤¤¤¤¤¤¤¤¤¤¤¤¤¤¤¤¤¤¤¤¤¤¤¤¤¤¤¤¤¤¤¤¤¤]
[¤¤¤¤¤¤§°°°°°°°°°°°°°°°°°°$¤¤¤][¤¤¤§°°°°°°°°°°°°°°°°°°°°°°°°°°°°°°°°°°&
[¤¤¤¤¤¤]                  [¤¤¤][¤¤¤]§^^^^^^^^^^^^^^^^^^^^^^^^^^^^^^^^^$
[¤¤¤¤¤¤]                  [¤¤¤][¤¤¤][¤¤¤¤¤¤¤¤¤¤¤¤¤¤¤¤¤¤¤¤¤¤¤¤¤¤¤¤¤¤¤¤¤]
[¤¤¤¤¤¤]                  [¤¤¤][¤¤¤][¤¤¤¤¤¤¤¤¤¤¤¤¤¤¤¤¤¤¤¤¤¤¤¤¤¤¤¤¤¤¤¤¤]
[¤¤¤¤¤¤]                  [¤¤¤][¤¤¤][¤¤¤¤¤¤¤¤¤¤¤¤¤¤¤¤¤¤¤¤¤¤¤¤¤¤¤¤¤¤¤¤¤]
[¤¤¤¤¤¤%^^^^^^^^^^^^^^^^^^&¤¤¤%&¤¤¤%&¤¤¤¤¤¤¤¤¤¤¤¤¤¤¤¤¤¤¤¤¤¤¤¤¤¤¤¤¤¤¤¤¤]
[¤¤¤¤¤¤¤¤¤¤¤¤¤¤¤¤¤¤¤¤¤¤¤¤¤¤¤¤¤¤¤¤¤¤¤¤¤¤¤¤¤¤¤¤§°°°°°°°°°°°°°°°°°°°°°°°°&
[¤¤¤¤¤¤¤¤¤¤¤¤¤¤¤¤¤¤¤¤¤¤¤¤¤¤¤¤¤¤¤¤¤¤¤¤¤¤¤¤¤¤¤¤]§^^^^^^^^^^^^^^^^^^^^^^^$
[¤¤¤¤¤¤§°°°°°°°°°°°°°°°°°°°°°°°°°°°°$¤¤¤¤¤¤¤¤][¤¤¤¤¤¤¤¤¤¤¤¤¤¤¤¤¤¤¤¤¤¤¤]
[¤¤¤¤¤¤]§^^^^^^^^^^^^^^^^^^^^^^^^^^^&¤¤¤¤¤¤¤¤][¤¤¤¤¤¤¤¤¤¤¤¤¤¤¤¤¤¤¤¤¤¤¤]
[¤¤¤¤¤¤][¤¤¤¤¤¤¤¤¤¤¤¤¤¤¤¤¤¤¤¤¤¤¤¤¤¤¤¤¤¤¤¤¤¤¤¤][¤¤¤¤¤¤¤¤¤¤¤¤¤¤¤¤¤¤¤¤¤¤¤]
[¤¤¤¤¤¤][¤¤¤¤¤¤¤¤¤¤¤¤¤¤¤¤¤¤¤¤¤¤¤¤¤¤¤¤¤¤¤¤¤¤¤¤][¤¤¤¤¤¤¤¤¤¤¤¤¤§°°°°°°°°°&
[¤¤¤¤¤¤][¤¤¤¤¤§°°$¤¤¤¤¤¤¤¤¤¤¤¤¤¤¤§°°°°°°°°°°°&[¤¤¤¤¤¤¤§$¤¤¤¤]§^^^^^^^^$
[¤¤¤¤¤¤][¤¤¤¤¤]  %°°°°°°°°$¤¤¤¤¤¤]§^^^^^^^^^^^&¤¤¤¤¤¤¤][¤¤¤¤][¤¤¤¤¤¤¤¤]
[¤¤¤¤¤¤][¤¤¤¤¤%^^^^^^^^^^^&¤¤¤¤¤¤][¤¤¤¤¤¤¤¤¤¤¤¤¤¤¤¤¤¤¤][¤¤¤¤][¤¤¤¤¤¤¤¤]
[¤¤¤¤¤¤][¤¤¤¤¤¤¤¤¤¤¤¤¤¤¤¤¤¤¤¤¤¤¤¤][¤¤¤¤¤¤¤¤¤¤¤¤¤¤¤¤¤¤¤][¤¤¤¤][¤¤¤¤¤¤¤¤]
[¤¤¤¤¤¤][¤¤¤¤¤¤¤¤¤¤¤¤¤¤¤¤¤¤¤¤¤¤¤¤][¤¤¤¤¤¤§°°°°°°°°°°°°&[¤¤¤¤][¤¤¤¤¤¤¤¤]
[¤¤¤¤¤¤]%°°°°°°°°°°°°°°°°°°°°°°°°&]¤¤¤¤¤¤]§^^^^^^^^^^^^&¤¤¤¤][¤¤¤¤¤¤¤¤]
[¤¤¤¤¤¤%^^^^^^^^^^^^^^^^^^^^^^^^^^&¤¤¤¤¤¤][¤¤¤¤¤¤¤¤¤¤¤¤¤¤¤¤¤][¤¤¤¤¤¤¤¤]
[¤¤¤¤¤¤¤¤¤¤¤¤¤¤¤¤¤¤¤¤¤¤¤¤¤¤¤¤¤¤¤¤¤¤¤¤¤¤¤¤][¤¤¤¤¤¤¤¤¤¤¤¤¤¤¤¤¤][¤¤¤¤¤¤¤¤]
[¤¤¤¤¤¤¤¤¤¤¤¤¤¤¤¤¤¤¤¤¤¤¤¤¤¤¤¤¤¤¤¤¤¤¤¤¤¤¤¤%&¤¤¤¤¤¤§°°°°°°°°°°&[¤¤¤¤¤¤¤¤]
[¤¤¤¤¤¤¤¤¤¤¤¤¤¤¤¤¤¤¤¤¤¤¤¤¤¤¤¤¤¤¤¤¤¤¤¤¤¤¤¤¤¤¤¤¤¤¤¤%^^^^^^^^^^^&¤¤¤¤¤¤¤¤]
[¤¤¤¤¤¤§°°°°°°°°°°°°°°°°°°°°°°°°°$¤¤¤¤¤¤¤¤¤¤¤¤¤¤¤¤¤¤¤¤¤¤¤¤¤¤¤¤¤¤¤¤¤¤¤¤]
[¤¤¤¤¤¤%^^^^^^^^^^^^^^^^^^^^^^^^^&¤¤¤¤¤¤¤§$¤¤¤¤¤¤¤¤¤¤¤¤¤¤¤¤¤¤¤¤¤¤¤¤¤¤¤]
[¤¤¤¤¤¤¤¤¤¤¤¤¤¤¤¤¤¤¤¤¤¤¤¤¤¤¤¤¤¤¤¤¤¤¤¤¤¤¤¤][¤¤¤¤¤¤¤¤¤¤¤¤¤¤¤¤¤¤¤¤¤¤¤¤¤¤¤]
[¤¤¤¤¤¤¤¤¤¤¤¤¤¤¤¤¤¤¤¤¤¤¤¤¤¤¤¤¤¤¤¤¤¤¤¤¤¤¤¤]%°°°°°°°°°°°°°°°°°°°°°$¤¤¤¤¤]
[¤¤¤¤§°°°°°°°°°°°°°°°°°°°°°°°°°°°$¤¤¤¤¤¤¤%^^^^^^^^^^^^^^^^^^^^^$[¤¤¤¤¤]
[¤¤¤¤]§^^^^^^^^^^^^^^^^^^^^^^^^^$[¤¤¤¤¤¤¤¤¤¤¤¤¤¤¤¤¤¤¤¤¤¤¤¤¤¤¤¤¤][¤¤¤¤¤]
[¤¤¤¤][¤¤¤¤¤¤¤¤¤¤¤¤¤¤¤¤¤¤¤¤¤¤¤¤¤][¤¤¤¤¤¤¤¤¤¤¤¤¤¤¤¤¤¤¤¤¤¤¤¤¤¤¤¤¤][¤¤¤¤¤]
[¤¤¤¤][¤¤¤¤¤¤¤¤¤¤¤¤¤¤¤¤¤¤¤¤¤¤¤¤¤][¤¤¤¤¤¤¤¤¤¤¤¤¤¤¤¤¤¤¤¤¤¤¤¤¤¤¤¤¤][¤¤¤¤¤]
[¤¤¤¤][¤¤¤¤¤¤¤¤¤¤¤¤¤¤¤¤¤¤¤¤¤¤¤¤¤]%°°°°°°°°°°°°°°°°°°°°°°°°°°°°°&[¤¤¤¤¤]
[¤¤¤¤][¤¤¤¤¤¤¤¤¤¤¤¤¤¤¤¤¤¤¤¤¤¤¤¤¤%^^^^^^^^^^^^^^^^^^^^^^^^^^^^^^^&¤¤¤¤¤]
[¤¤¤¤][¤¤¤¤¤¤¤¤¤¤¤¤¤¤¤¤¤¤¤¤¤¤¤¤¤¤¤¤¤¤¤¤¤¤¤¤¤¤¤¤¤¤¤¤¤¤¤¤¤¤¤¤¤¤¤¤¤¤¤¤¤¤¤]
[¤¤¤¤][¤¤¤¤¤¤¤¤¤¤¤¤¤¤¤¤¤¤¤¤¤¤¤¤¤¤¤¤¤¤¤¤¤¤¤¤¤¤¤¤¤¤¤¤¤¤¤¤¤¤¤¤¤¤¤¤¤¤¤¤¤¤¤]
%°°°°&%°°°°°°°°°°°°°°°°°°°°°°°°°°°°°°°°°°°°°°°°°°°°°°°°°°°°°°°°°°°°°°°&
