§^^^^^$§^^^^^^^^^^^^^^^^^^^^^^^^^^^^^^$§^^^^^^^^^^^^^^^^^^^^^$§^^^^^^^$
[¤¤¤¤¤][¤¤¤¤¤¤¤¤¤¤¤¤¤¤¤¤¤¤¤¤¤¤¤¤¤¤¤¤¤¤][¤¤¤¤¤¤¤¤¤¤¤¤¤¤¤¤¤¤¤¤¤][¤¤¤¤¤¤¤]
[¤¤¤¤¤][¤¤¤¤¤¤¤¤¤¤¤¤¤¤¤¤¤¤¤¤¤¤¤¤¤¤¤¤¤¤][¤¤¤¤¤¤¤¤¤¤¤¤¤¤¤¤¤¤¤¤¤][¤¤¤¤¤¤¤]
[¤¤¤¤¤][¤¤¤¤¤¤¤¤¤§$¤¤¤¤¤¤¤¤¤¤¤¤¤¤¤¤¤¤¤][¤¤¤¤¤¤¤¤¤¤¤¤¤¤¤¤¤¤¤¤¤][¤¤¤¤¤¤¤]
[¤¤¤¤¤][¤¤¤¤¤¤¤¤¤]%°°°°°°°°°°°°°°°°°°°&%°°°°°$¤¤¤¤§°°°°°°°°°°][¤¤¤¤¤¤¤]
[¤¤¤¤¤][¤¤¤¤¤¤¤¤¤%^^^^^^^^^^^^^^^^^^^^^^^^^^$[¤¤¤¤%^^^^^^^^^^][¤¤¤¤¤¤¤]
[¤¤¤¤¤][¤¤¤¤¤¤¤¤¤¤¤¤¤¤¤¤¤¤¤¤¤¤¤¤¤¤¤¤¤¤¤¤¤¤¤¤][¤¤¤¤¤¤¤¤¤¤¤¤¤¤¤][¤¤¤¤¤¤¤]
[¤¤¤¤¤][¤¤¤¤¤¤¤¤¤¤¤¤¤¤¤¤¤¤¤¤¤¤¤¤¤¤¤¤¤¤¤¤¤¤¤¤][¤¤¤¤¤¤¤¤¤¤¤¤¤¤¤][¤¤¤¤¤¤¤]
[¤¤¤¤¤[%°°°°°°°°°°°°°°°°°°°°°°°°°°°°°°°°°$¤¤][¤¤¤¤¤§°°°°°°°°°&[¤¤¤¤¤¤¤]
[¤¤¤¤¤%^^^^^^^^^^^^^^^^^^^^^^^^^^^^^^^^^$[¤¤][¤¤¤¤¤%^^^^^^^^^^&¤¤¤¤¤¤¤]
[¤¤¤¤¤¤¤¤¤¤¤¤¤¤¤¤¤¤¤¤¤¤¤¤¤¤¤¤¤¤¤¤¤¤¤¤¤¤¤][¤¤][¤¤¤¤¤¤¤¤¤¤¤¤¤¤¤¤¤¤¤¤¤¤¤¤]
[¤¤¤¤¤¤¤¤¤¤¤¤¤¤¤¤¤¤¤¤¤¤¤¤¤¤¤¤¤¤¤¤¤¤¤¤¤¤¤][¤¤][¤¤¤¤¤¤¤¤¤¤¤¤¤¤¤¤¤¤¤¤¤¤¤¤]
[¤¤¤¤¤¤¤¤¤¤¤¤¤¤¤¤¤¤¤¤¤¤¤¤¤¤¤¤¤¤¤¤¤¤¤¤¤¤¤%&¤¤%&¤¤¤¤¤¤¤¤¤¤¤¤¤¤¤¤¤¤¤¤¤¤¤¤]
[¤¤¤¤¤§$¤¤¤¤¤¤§$¤¤¤¤¤¤¤¤¤¤¤¤¤¤¤¤¤¤¤¤¤¤¤¤¤¤¤¤¤¤¤¤¤¤¤¤¤¤¤¤¤¤¤¤¤¤¤¤¤¤¤¤¤¤]
[¤¤¤¤¤][¤¤¤¤¤¤][¤¤¤¤¤¤¤¤¤¤¤¤¤¤¤¤¤¤¤¤¤¤¤¤¤¤¤¤¤¤¤¤¤¤¤¤¤¤¤¤¤¤¤¤¤¤¤¤¤¤¤¤¤¤]
[¤¤¤¤¤][¤¤¤¤¤¤][¤¤¤¤¤¤¤¤¤¤¤¤¤¤¤¤¤¤¤¤¤¤¤¤¤¤¤¤¤¤¤¤¤¤¤¤¤¤¤¤¤¤¤¤¤¤¤¤¤¤¤¤¤¤]
[¤¤¤¤¤][¤¤¤¤¤¤][¤¤¤¤¤§$¤¤¤¤¤¤§°°°°°°°°°°°°°°°°°°°°°°°°°°°°°°°°°°°°°°°°&
[¤¤¤¤¤][¤¤¤¤¤¤][¤¤¤¤¤][¤¤¤¤¤¤]§^^^^^^^^^^^^^^^^^^^^^^^^^^^^^^^^^^^^^^^$
[¤¤¤¤¤][¤¤¤¤¤¤][¤¤¤¤¤][¤¤¤¤¤¤][¤¤¤¤¤¤¤¤¤¤¤¤¤¤¤¤¤¤¤¤¤¤¤¤¤¤¤¤¤¤¤¤¤¤¤¤¤¤¤]
[¤¤¤¤¤][¤¤¤¤¤¤][¤¤¤¤¤][¤¤¤¤¤¤][¤¤¤¤¤¤¤¤¤¤¤¤¤¤¤¤¤¤¤¤¤¤¤¤¤¤¤¤¤¤¤¤¤¤¤¤¤¤¤]
[¤¤¤¤¤][¤¤¤¤¤¤][¤¤¤¤¤][¤¤¤¤¤¤][¤¤¤¤¤¤¤¤¤¤¤¤¤¤¤¤¤¤¤¤¤¤¤¤¤¤¤¤¤¤¤¤¤¤¤¤¤¤¤]
[¤¤¤¤¤][¤¤¤¤¤¤][¤¤¤¤¤][¤¤¤¤¤¤][¤¤¤¤§°°°°°°°°°°°°°°°°°°°°°°°°°°°°°$¤¤¤¤]
[¤¤¤¤¤][¤¤¤¤¤¤][¤¤¤¤¤][¤¤¤¤¤¤][¤¤¤¤]§^^^^^^^^^^^^^^^^^^^^^^^^^^^^&¤¤¤¤]
[¤¤¤¤¤][¤¤¤¤¤¤][¤¤¤¤¤][¤¤¤¤¤¤][¤¤¤¤][¤¤¤¤¤¤¤¤¤¤¤¤¤¤¤¤¤¤¤¤¤¤¤¤¤¤¤¤¤¤¤¤¤]
[¤¤¤¤¤%&¤¤¤¤¤¤][¤¤¤¤¤][¤¤¤¤¤¤%&¤¤¤¤][¤¤¤¤¤¤¤¤¤¤¤¤¤¤¤¤¤¤¤¤¤¤¤¤¤¤¤¤¤¤¤¤¤]
[¤¤¤¤¤¤¤¤¤¤¤¤¤][¤¤¤¤¤][¤¤¤¤¤¤¤¤¤¤¤¤][¤¤¤¤¤¤¤¤¤¤¤¤¤¤¤¤¤¤¤¤¤¤¤¤¤¤¤¤¤¤¤¤¤]
[¤¤¤¤¤¤¤¤¤¤¤¤¤][¤¤¤¤¤%&¤¤¤¤¤¤¤¤¤¤¤¤][¤¤¤¤¤¤¤¤¤¤§°°°°°°°°°°°°°°°°°°°°°°&
[¤¤¤¤¤¤¤¤¤¤¤¤¤][¤¤¤¤¤¤¤¤¤¤¤¤¤¤¤¤¤¤¤][¤¤¤¤¤¤¤¤¤¤]           §^^^^^^^^^^$
[¤¤¤¤¤§$¤¤¤¤¤¤][¤¤¤¤¤¤¤¤¤¤¤¤¤¤¤¤¤¤¤][¤¤¤¤¤¤¤¤¤¤]           [¤¤¤¤¤¤¤¤¤¤]
[¤¤¤¤¤][¤¤¤¤¤¤][¤¤¤¤¤¤¤¤¤¤¤¤¤¤¤¤¤¤¤][¤¤¤¤¤¤¤¤¤¤]           [¤¤¤¤¤¤¤¤¤¤]
[¤¤¤¤¤][¤¤¤¤¤¤]%°°°°°°°°°°°°°°°°°°°&[¤¤¤¤¤¤¤¤¤¤]           [¤¤¤¤¤¤¤¤¤¤]
[¤¤¤¤¤][¤¤¤¤¤¤%^^^^^^^^^^^^^^^^^^^^^&¤¤¤¤¤¤¤¤¤¤]           [¤¤¤¤¤¤¤¤¤¤]
[¤¤¤¤¤][¤¤¤¤¤¤¤¤¤¤¤¤¤¤¤¤¤¤¤¤¤¤¤¤¤¤¤¤¤¤¤¤¤¤¤¤¤¤¤]           [¤¤¤¤¤¤¤¤¤¤]
[¤¤¤¤¤][¤¤¤¤¤¤¤¤¤¤¤¤¤¤¤¤¤¤¤¤¤¤¤¤¤¤¤¤¤¤¤¤¤¤¤¤¤¤¤]           [¤¤¤¤¤¤¤¤¤¤]
[¤¤¤¤¤][¤¤¤¤¤¤¤¤¤¤¤¤¤¤¤¤¤¤¤¤¤¤¤¤¤¤¤¤¤¤¤¤¤¤¤¤¤¤¤%^^^^^^^^^^^&¤¤¤¤¤¤¤¤¤¤]
[¤¤¤¤¤][¤¤¤¤¤¤¤§°°°°°°°°°°°°°°°°°°°°$¤¤¤¤¤¤¤¤¤¤¤¤¤¤¤¤¤¤¤¤¤¤¤¤¤¤¤¤¤¤¤¤¤]
[¤¤¤¤¤][¤¤¤¤¤¤¤]§^^^^^^^^^^^^^^^^^^^&¤¤¤¤¤¤¤¤¤¤¤¤¤¤¤¤¤¤¤¤¤¤¤¤¤¤¤¤¤¤¤¤¤]
[¤¤¤¤¤][¤¤¤¤¤¤¤][¤¤¤¤¤¤¤¤¤¤¤¤¤¤¤¤¤¤¤¤¤¤¤¤¤¤¤¤¤¤¤¤¤¤¤¤¤¤¤¤¤¤¤¤¤¤¤¤¤¤¤¤¤]
[¤¤¤¤¤][¤¤¤¤¤¤¤][T¤¤¤¤¤¤¤¤¤¤¤¤¤¤¤¤¤¤¤¤¤¤¤¤¤¤¤¤¤¤¤¤¤¤¤¤¤¤¤¤¤¤¤¤¤¤¤¤¤¤¤¤]
%°°°°°&%°°°°°°°&%°°°°°°°°°°°°°°°°°°°°°°°°°°°°°°°°°°°°°°°°°°°°°°°°°°°°°&
