§^^^^^^^^^^^^^^^^^^$..............
[¤¤¤¤¤¤¤¤¤¤¤¤¤¤¤¤¤¤]...........   
[¤M¤¤¤¤¤¤¤¤¤¤¤¤¤¤¤¤]..............
[¤¤¤¤¤¤¤¤¤¤¤¤¤¤¤¤¤¤{^^^^^^^^^^^^$.
[¤¤¤¤¤¤¤¤()¤¤¤¤¤¤¤¤¤¤¤¤¤¤¤¤¤¤T¤¤].
[¤¤¤¤¤¤¤¤{}¤¤¤¤¤¤¤¤¤¤¤¤¤¤¤¤§°°°°&.
[¤¤¤¤¤¤¤¤¤¤¤¤¤¤¤¤¤¤(°°°°°°°&......
[¤¤¤¤¤¤¤¤¤¤¤¤MM¤¤¤¤]..............
%°°°°°°$¤¤§°°°°°°°°&..............
§^^^^^^&¤¤%^^^^^^^^$..............
[¤¤¤¤¤¤¤¤¤¤¤¤¤¤¤¤¤¤]...........   
[¤M¤¤¤¤¤¤¤¤¤¤¤¤¤¤¤¤]..............
[¤¤¤¤¤¤¤¤¤¤¤¤¤¤¤¤¤¤{^^^^^^^^^^^^$.
[¤¤¤¤¤¤¤¤()¤¤¤¤¤¤¤¤¤¤¤¤¤¤¤¤¤¤T¤¤].
[¤¤¤¤¤¤¤¤{}¤¤¤¤¤¤¤¤¤¤¤¤¤¤¤¤§°°°°&.
[¤¤¤¤¤¤¤¤¤¤¤¤¤¤¤¤¤¤(°°°°°°°&......
[¤¤¤¤¤¤¤¤¤¤¤¤MM¤¤¤¤]..............
%°°°°°°°°°°°°°°°°°°&..............




