H
§^^^^^^^^^^^^^^^^^^$ §^^^^^^^^^^^^^^^^^^^^^^^^^^^^^^$
[¤¤¤¤¤¤¤¤¤¤¤¤¤¤¤¤¤¤] [¤¤¤¤¤¤¤¤¤¤¤¤¤¤¤¤¤¤¤¤¤¤¤¤¤¤¤¤¤¤]  
[¤M(°°°°°)¤¤¤()¤¤¤¤] %°°°°°°)¤(°°°°°°°°°°°°°°°°°°°)¤]
[¤¤{^^^^^}¤¤¤{}¤¤¤¤{^^^^^^^^}¤{^^^^^^^$ §^^^$§^^$ [¤]
[¤¤¤¤¤¤¤¤¤¤¤¤¤¤¤¤¤¤¤¤¤¤¤¤¤¤¤¤¤¤¤¤¤¤¤¤¤] [¤¤¤{}¤¤{^}¤]
[¤¤¤¤¤¤¤¤¤¤¤¤¤¤¤¤¤¤¤¤¤¤¤¤¤¤(°°°°°°°°)¤] [¤¤¤¤¤¤¤¤¤¤¤]
[¤¤¤¤¤¤¤¤¤¤¤¤¤¤¤¤¤¤(°)¤(°°°&....§^^^}¤] [¤¤¤()¤¤(°)¤]
[¤¤¤¤¤¤¤¤¤¤¤¤MM¤¤¤¤].[¤]....§^$.[¤¤¤¤¤] %°°°&%°°& [¤]
%°°°°°°)¤¤(°°°°°°°°&§}¤{$. .[¤].[¤(°°°&           [¤]
§^^^^^^}¤¤{^^^^^^^^$[¤¤¤]§^^}¤{^}¤].           §^^}¤]
[¤¤¤¤¤¤¤¤¤¤¤¤¤¤¤¤¤¤][¤¤¤][¤¤¤¤¤¤¤¤]            [¤¤¤¤]
[¤M()¤¤¤¤¤¤¤¤¤¤()¤¤]%°°°&[¤(°°°°°°&            %°°)¤]
[¤¤{}¤¤¤¤¤¤¤¤¤¤{}¤¤{^^^^^}¤{^^^^$.                %°&
[¤¤¤¤¤¤¤¤¤¤¤¤¤¤¤¤¤¤¤¤¤¤¤¤¤¤¤¤T¤¤].
[¤¤()¤¤¤¤¤¤¤¤¤¤¤¤¤¤¤¤¤¤¤¤¤¤(°°°°&.
[¤¤{}¤¤¤¤¤¤¤¤¤¤¤¤¤¤(°°°°°°°&......
[¤¤¤¤¤¤¤¤¤¤¤¤MM¤¤¤¤]..............
%°°°°°°°°°°°°°°°°°°&..............




