H
§^^^^^^^^^^^^^^^^^^$ §^^^^^^^^^^^^^^^^^^^^^^^^^^^^^^$
[S¤¤¤¤¤¤¤¤¤¤¤¤¤¤¤¤¤] [SS¤¤¤¤¤¤¤¤¤¤¤¤¤¤¤¤¤¤¤¤¤¤¤¤¤¤¤¤]  
[¤¤(°°°°°)¤¤¤()¤¤¤¤] %°°°°°°)¤(°°°°°°°°°°°°°°°°°°°)¤]
[¤¤]§^^^^}¤¤¤][¤¤¤¤{^^^^^^^^}¤{^^^^^^^$ §^^^$§^^$ [¤]
%°°&[¤¤¤¤¤¤¤¤][¤¤¤¤¤¤¤¤¤¤¤¤¤¤¤¤¤¤¤¤¤¤¤] [S¤S{}¤¤{^}¤]
§^^^}¤¤(°°°°°&[¤¤¤¤¤¤¤¤¤¤¤¤(°°°°°°°°)¤] [SSS¤¤¤¤¤¤¤¤]
[¤¤¤¤¤¤{^^^^^^}¤¤¤¤(°)¤(°°°&....§^^^}¤] [SS¤()¤¤(°)¤]
[¤¤¤¤¤¤¤¤¤¤¤¤¤¤¤¤¤¤].[¤]....§^$.[¤¤¤¤¤] %°°°&%°°& [¤]
%°°°°°°)¤¤(°°°°°°°°&§}¤{$. .[¤].[¤(°°°&  §^$ §^$  [¤]
§^^^^^^}¤¤{^^^^^^^^$[¤¤¤]§^^}¤{^}¤].  §^^}S{^}S{^^}¤]
[¤¤¤¤¤¤¤¤¤¤¤¤¤¤¤¤¤¤][¤¤¤][¤¤¤¤¤¤¤¤]   [¤¤¤¤¤¤¤¤¤SSMS]
[¤M()¤¤()¤¤()¤¤()¤¤]%°°°&[¤(°°°°°°&   %°°°°°°°°°°°)S]
[¤¤{}¤¤{}¤¤{}¤¤{}¤¤{^^^^^}¤{^^^^$.                %°&
[¤¤¤¤¤¤¤¤¤¤¤¤¤¤¤¤¤¤¤¤¤¤¤¤¤¤¤¤T¤¤].
[¤¤()¤¤()¤¤()¤¤()¤¤¤¤¤¤¤¤¤¤(°°°°&.
[¤M{}¤¤{}¤¤{}¤¤{}¤¤(°°°°°°°&......
[¤¤¤¤¤¤¤¤¤¤¤¤MM¤¤¤¤]..............
%°°°°°°°°°°°°°°°°°°&..............




