L
§^^^^^^^^^^^$§^^^^^^^^^^^^^^^^^^^^^^^^^^^^^$§^^^^^^^^^^^^^^^^^^^^^^^^^$
[¤¤¤¤¤T¤¤¤¤¤][¤¤¤¤¤¤¤¤¤¤¤¤¤¤¤¤¤¤¤¤¤¤¤¤¤¤¤¤¤][¤¤¤¤¤¤¤¤¤¤¤¤¤¤¤¤¤¤¤¤¤¤¤¤¤]
[¤¤¤¤¤¤¤¤¤¤¤][¤¤¤¤¤¤¤¤¤¤¤¤¤¤¤¤¤¤¤¤¤¤¤¤¤¤¤¤¤][¤¤¤¤¤¤¤¤¤¤¤¤¤¤¤¤¤¤¤¤¤¤¤¤¤]
[¤¤¤¤¤¤¤¤¤¤¤][¤¤¤¤¤¤§°°°°°°°°°°°°°°°$¤¤¤¤¤¤][¤¤¤¤¤¤¤¤¤¤¤¤¤¤¤¤¤¤¤¤¤¤¤¤¤]
[¤¤¤¤¤¤¤¤¤¤¤¤¤¤¤¤¤¤¤]§^^^^^^^^^^^^^^&¤¤¤¤¤¤][¤¤¤§°°°°°$¤¤¤¤¤§°°°°°°°°°&
[¤¤¤¤¤¤¤¤¤¤¤¤¤¤¤¤¤¤¤][¤¤¤¤¤¤¤¤¤¤¤¤¤¤¤¤¤¤¤¤¤][¤¤¤]$^^^^&¤¤¤¤¤%^^^^^^^^^]
[¤¤¤¤¤¤¤¤¤¤¤¤¤¤¤¤¤¤¤][¤¤¤¤¤¤¤¤¤¤¤¤¤¤¤¤¤¤¤¤¤][¤¤¤][¤¤¤¤¤¤¤¤¤¤¤¤¤¤¤¤¤¤¤¤]
%°°°°°°°°°°°°°°°°°°°&[¤¤¤¤¤¤¤¤¤§°°°°°°°°°°°$[¤¤¤][¤¤¤¤¤¤¤¤¤¤¤¤¤¤¤¤¤¤¤¤]
§^^^^^^^^^^^^^^^^^^^^&¤¤¤¤¤¤¤¤¤]^^^^^^^^^^^^&¤¤¤][¤¤¤¤¤¤¤¤¤¤¤¤¤¤¤¤¤¤¤¤]
[¤¤¤¤¤¤¤¤¤¤¤¤¤¤¤¤¤¤¤¤¤¤¤¤¤¤¤¤¤¤][¤¤¤¤¤¤¤¤¤¤¤¤¤¤¤][¤¤¤¤¤¤¤¤¤§^^$¤¤¤¤¤¤¤]
[¤¤¤¤¤¤¤¤¤¤¤¤¤¤¤¤¤¤¤¤¤¤¤¤¤¤¤¤¤¤][¤¤¤¤¤¤¤¤¤¤¤¤¤¤¤][¤¤¤¤¤¤¤¤¤[¤¤]¤¤¤¤¤¤¤]
[°°°°$¤¤§°°°°°&¤¤¤¤¤¤¤§°°°°°°°°&[¤¤¤¤¤¤¤¤¤¤¤¤¤¤¤][¤¤¤¤¤¤¤¤¤[¤¤]¤¤¤¤¤¤¤]
[^^^^&¤¤%^^^^^[¤¤¤¤¤¤¤]§^^^^^^^^%¤¤¤¤¤¤¤¤¤¤¤¤¤¤¤][¤¤¤¤¤¤¤¤¤[¤¤]¤¤¤¤¤¤¤]
[¤¤¤¤¤¤¤¤¤¤¤¤¤[¤¤¤¤¤¤¤][¤¤¤¤¤¤¤¤¤¤¤¤¤¤¤¤¤¤¤¤¤¤¤¤][¤¤¤¤¤¤¤¤¤[¤¤]¤¤¤¤¤¤¤]
[¤¤¤¤¤¤¤¤¤¤¤¤¤[¤¤¤¤¤¤¤][¤¤¤¤¤¤¤¤¤¤¤¤¤¤¤¤¤¤¤¤¤¤¤¤][¤¤¤¤¤¤¤¤¤[¤¤]¤¤¤¤¤¤¤]
[¤¤¤¤¤¤¤¤¤¤¤¤¤[¤¤¤¤¤¤¤][¤¤¤¤¤¤¤¤¤¤¤¤¤¤¤¤¤§°°°°°°&[¤¤¤¤¤¤¤¤¤%°°&¤¤¤¤¤¤¤]
[¤¤¤¤¤¤¤¤¤¤¤¤¤[¤¤¤¤¤¤¤][¤¤¤¤¤¤¤¤¤¤¤¤¤¤¤¤¤§^^^^^^$[¤¤¤¤¤¤¤¤¤¤¤¤¤¤¤¤¤¤¤¤]
%°°°°°°°°°°°°&[¤¤¤¤¤¤¤][¤¤¤¤¤¤¤¤¤¤¤¤¤¤¤¤¤¤¤¤¤¤¤¤][¤¤¤¤¤¤¤¤¤¤¤¤¤¤¤¤¤¤¤¤]
[^^^^^^^^^^^^^$¤¤¤¤¤¤¤][¤¤¤¤¤¤¤¤¤¤¤¤¤¤¤¤¤¤¤¤¤¤¤¤][¤¤¤¤¤¤¤¤¤¤¤¤¤¤¤¤¤¤¤¤]
[¤¤¤¤¤¤¤¤¤¤¤¤¤¤¤¤¤¤¤¤¤][¤¤¤¤¤¤¤¤¤¤¤¤¤¤¤¤¤¤¤¤¤¤¤¤]%°°°°°°°°°°°°°°°°°°°°]
[¤¤¤¤¤¤¤¤¤¤¤¤¤¤¤¤¤¤¤¤¤][¤¤¤¤¤¤¤¤¤¤¤¤¤¤¤¤¤¤¤¤¤¤¤¤%^^^^^^^^^^^^^^^^^^^^^]
[¤¤¤¤¤¤¤¤¤¤¤¤¤¤¤¤¤¤¤¤¤][¤¤¤¤¤¤¤¤¤¤¤¤¤¤¤¤¤¤¤¤¤¤¤¤¤¤¤¤¤¤¤¤¤¤¤¤¤¤¤¤¤¤¤¤¤¤]
[¤¤¤¤¤¤¤§°°°°°°°°°°°°°&%°°°$¤¤¤¤¤¤¤¤¤¤¤¤¤¤¤¤¤¤¤¤¤¤¤¤¤¤¤¤¤¤¤¤¤¤¤¤¤¤¤¤¤¤]
[¤¤¤¤¤¤¤]§^^^^^^^^^^^^^^^^$[¤¤¤¤¤¤¤¤¤§^^^^^^^^^^^^^^^^^^^^^^^^^^^^^^^^&
[¤¤¤¤¤¤¤][¤¤¤¤¤¤¤¤¤¤¤¤¤¤¤¤][¤¤¤¤¤¤¤¤¤%°°°°°°°°°°°°°°°°°°°°°°°°°°°°°°°°$
[¤¤¤¤¤¤¤]°°°[¤¤¤¤¤¤¤¤¤¤¤¤¤][¤¤¤¤¤¤¤¤¤¤¤¤¤¤¤¤¤¤¤¤¤¤¤¤¤¤¤¤¤¤¤¤¤¤¤¤¤¤¤¤¤¤]
[¤¤¤¤¤¤¤§^^^%¤¤¤¤¤¤¤¤¤¤¤¤¤][¤¤¤¤¤¤¤¤¤¤¤¤¤¤¤¤¤¤¤¤¤¤¤¤¤¤¤¤¤¤¤¤¤¤¤¤¤¤¤¤¤¤]
[¤¤¤¤¤¤¤¤¤¤¤¤¤¤¤¤¤¤¤¤¤¤¤¤¤][¤¤¤¤¤¤¤¤¤¤¤¤¤¤¤¤¤¤¤¤¤¤¤¤¤¤¤¤¤¤¤¤¤¤¤¤¤¤¤¤¤¤]
[¤¤¤¤¤¤¤]§¤¤¤¤¤¤¤¤¤¤¤¤¤¤¤¤]%°°°°°°°°°°°°°°°°°°°°°°°°°°°°°°°°°°$¤¤¤¤¤¤¤]
[¤¤¤¤¤¤¤]%°°°°°°°°°°°°°°°°&^^^^^^^^^^^^^^^^^^^^^^^^^^^^^^^^^^^&¤¤¤¤¤¤¤&
[¤¤¤¤¤¤¤][¤¤¤¤¤¤¤¤¤¤¤¤¤¤¤¤¤¤¤¤¤¤¤¤¤¤¤¤¤¤¤¤¤¤¤¤¤¤¤¤¤¤¤¤¤¤¤¤¤¤¤¤¤¤¤¤¤¤¤¤]
[¤¤¤¤¤¤¤][¤¤¤¤¤¤¤¤¤¤¤¤¤¤¤¤¤¤¤¤¤¤¤¤¤¤¤¤¤¤¤¤¤¤¤¤¤¤¤¤¤¤¤¤¤¤¤¤¤¤¤¤¤¤¤¤¤¤¤¤]
[¤¤¤¤¤¤¤][¤¤¤¤¤¤¤¤¤¤¤¤¤¤¤¤¤¤¤¤¤¤¤¤¤¤¤¤¤¤¤¤¤¤¤¤¤¤¤¤¤¤¤¤¤¤¤¤¤¤¤¤¤¤¤¤¤¤¤¤]
[¤¤¤¤¤¤¤][¤¤¤¤¤¤¤¤¤¤¤¤¤¤¤¤¤¤¤¤¤¤¤¤¤¤¤¤¤¤¤¤¤¤¤¤¤¤¤¤¤¤¤¤¤¤¤¤¤¤¤¤¤¤¤¤¤¤¤¤]
[¤¤¤¤¤¤¤][¤¤¤¤¤¤¤¤¤¤¤¤¤¤¤¤§°°°°°°°°°°°°°°°°$¤¤¤¤¤§¤¤¤¤¤¤¤¤¤¤¤¤¤¤¤¤¤¤¤¤]
[¤¤¤¤¤¤¤%&¤¤¤¤¤¤¤¤¤¤¤¤¤¤¤¤]§^^^^^^^^^^^^^^&¤¤¤¤¤¤%^^^^^^^^^^^^^^^^^^^^$
[¤¤¤¤¤¤¤¤¤¤¤¤¤¤¤¤¤¤¤¤¤¤¤¤¤][¤¤¤¤¤¤¤¤¤¤¤¤¤¤¤¤¤¤¤¤¤¤¤¤¤¤¤¤¤¤¤¤¤¤¤¤¤¤¤¤¤¤]
[¤¤¤¤¤¤¤¤¤¤¤¤¤¤¤¤¤¤¤¤¤¤¤¤¤][¤¤¤¤¤¤¤¤¤¤¤¤¤¤¤¤¤¤¤¤¤¤¤¤¤¤¤¤¤¤¤¤¤¤¤¤¤¤¤¤¤¤]
[¤¤¤¤¤¤¤¤¤¤¤¤¤¤¤¤¤¤¤¤¤¤¤¤¤][¤¤¤¤¤¤¤¤¤¤¤¤¤¤¤¤¤¤¤¤¤¤¤¤¤¤¤¤¤¤¤¤¤¤¤¤¤¤¤¤¤¤]
%°°°°°°°°°°°°°°°°°°°°°°°°°&%°°°°°°°°°°°°°°°°°°°°°°°°°°°°°°°°°°°°°°°°°°&

