H
§^^^^^^^^^^^^^^^^^^$ §^^^^^^^^^^^^^^^^^^^^^^^^^^^^^^$
[S¤¤¤¤¤¤¤¤¤J¤¤¤¤¤¤¤] [SS¤J¤¤¤¤¤¤¤¤¤¤¤¤¤¤¤¤¤¤¤¤¤¤¤¤¤¤]  
[¤¤(°°°°°)¤¤¤()¤¤¤¤] %°°°°°°)¤(°°°°°°°°°°°°°°°°°°°)¤]
[¤J]§^^^^}¤¤¤][¤¤¤¤{^^^^^^^^}¤{^^^^^^^$ §^^^$§^^$ [¤]
%°°&[¤¤¤¤¤¤¤¤][¤¤¤¤¤¤¤¤¤¤¤¤¤¤¤¤¤¤¤¤¤¤¤] [S¤S{}J¤{^}¤]
§^^^}¤¤(°°°°°&[¤¤¤¤¤¤¤¤¤¤¤¤(°°°°°°°°)¤] [SSS¤¤¤¤¤¤¤¤]
[¤¤¤¤¤¤{^^^^^^}¤¤¤¤(°)¤(°°°&....§^^^}¤] [SS¤()¤¤(°)¤]
[¤¤¤¤¤¤¤¤¤¤¤¤¤¤¤¤¤¤].[¤]....§^$.[¤¤¤¤¤] %°°°&%°°& [¤]
%°°°°°°)¤¤(°°°°°°°°&§}¤{$. .[¤].[¤(°°°&  §^$ §^$  [¤]
§^^^^^^}¤¤{^^^^^^^^$[¤¤¤]§^^}¤{^}¤].  §^^}S{^}S{^^}¤]
[J¤¤¤¤¤¤¤¤¤¤¤¤¤¤¤¤¤][¤¤¤][¤¤¤¤¤¤¤¤]   [¤JJ¤¤¤¤¤¤SSMS]
[¤M()¤¤()¤¤()¤¤()¤¤]%°°°&[¤(°°°°°°&   %°°°°°°°°°°°)S]
[¤¤{}¤¤{}¤¤{}¤¤{}¤¤{^^^^^}¤{^^^^$.                %°&
[¤¤¤¤¤¤¤¤¤¤¤¤¤¤¤¤¤¤¤¤¤¤¤¤¤¤¤¤T¤¤].
[¤¤()¤¤()¤¤()¤¤()¤¤¤¤¤¤¤¤¤¤(°°°°&.
[¤M{}¤¤{}¤¤{}¤¤{}¤¤(°°°°°°°&......
[J¤¤¤¤¤¤¤¤¤¤¤MM¤¤¤¤]..............
%°°°°°°°°°°°°°°°°°°&..............




