§^^^^^^^^^^^^^^^^^^^^^^^^^^^^^^^^^$                
[¤¤¤¤¤¤¤¤¤¤¤¤¤¤¤¤¤¤¤¤¤¤¤¤¤¤¤¤¤¤¤¤¤]               
[¤¤¤¤¤¤¤¤¤¤¤¤¤¤¤¤¤¤¤¤¤¤¤¤¤¤¤¤¤¤¤¤¤]               
%°°°°°°°°°°°°°$¤¤¤¤¤¤¤¤¤¤¤¤¤¤¤¤¤¤¤]                
              [¤¤¤¤¤¤¤¤¤¤¤¤¤¤¤¤¤¤¤]               
              [¤¤¤¤¤¤¤¤¤¤¤¤¤¤¤¤¤¤¤]                 
              [¤¤¤¤¤¤¤¤¤¤¤¤¤¤¤¤¤¤¤]               
              [¤¤¤¤¤¤¤¤¤¤¤¤¤¤¤¤¤¤¤]               
              [¤¤¤¤¤¤¤¤¤¤¤¤¤¤¤¤¤¤¤]               
              [¤¤¤¤¤¤¤¤¤¤¤¤¤¤¤¤¤¤¤]               
              [¤¤¤¤¤¤¤¤¤¤¤¤¤¤¤¤¤¤¤]               
              [¤¤¤¤¤¤¤¤¤¤¤¤¤¤¤¤¤¤¤]               
              [¤¤¤¤¤¤¤¤¤¤¤¤¤¤¤¤¤¤¤]                
              [¤¤¤¤¤¤¤¤¤¤¤¤¤¤¤¤¤¤¤]               
              [¤¤¤¤¤¤¤¤¤¤¤¤¤¤¤¤¤¤¤]               
              [¤¤¤¤¤¤¤¤¤¤¤¤¤¤¤¤¤¤¤]               
              %°°°°°°°°$¤§°°°°°°°°&                 
§^^^^^^^^^^^^^^^^^^^^^^&T%^^^^^^^^^^^^^^^^^^^^^^^$
[¤¤¤¤¤¤¤¤¤¤¤¤¤¤¤¤¤¤¤¤¤¤¤¤¤¤¤¤¤¤¤¤¤¤¤¤¤¤¤¤¤¤¤¤¤¤¤¤]
[¤¤¤¤¤¤¤¤¤¤¤¤¤¤¤¤¤¤¤¤¤¤¤¤¤¤¤¤¤¤¤¤¤¤¤¤¤¤¤¤¤¤¤¤¤¤¤¤]
[¤¤¤¤¤¤¤¤¤¤¤¤¤¤¤¤¤¤¤¤¤¤¤¤¤¤¤¤¤¤¤¤¤¤¤¤¤¤¤¤¤¤¤¤¤¤¤¤]
[¤¤¤¤¤¤¤¤¤¤¤¤¤¤¤¤¤¤¤¤¤¤¤¤¤¤¤¤¤¤¤¤¤¤¤¤¤¤¤¤¤¤¤¤¤¤¤¤]
[¤¤¤¤¤¤¤¤¤¤¤¤¤¤¤¤¤¤¤¤¤¤¤¤¤¤¤¤¤¤¤¤¤¤¤¤¤¤¤¤¤¤¤¤¤¤¤¤]
[¤¤¤¤¤¤¤¤¤¤¤¤¤¤¤¤¤¤¤¤¤¤¤¤¤¤¤¤¤¤¤¤¤¤¤¤¤¤¤¤¤¤¤¤¤¤¤¤]
[¤¤¤¤¤¤¤¤§^^^^$¤¤¤¤¤¤¤¤¤¤¤¤¤¤¤¤¤¤¤§^^^^$¤¤¤¤¤¤¤¤¤]
[¤¤¤¤¤¤¤¤]    [¤¤¤¤¤¤¤¤¤¤¤¤¤¤¤¤¤¤¤]    [¤¤¤¤¤¤¤¤¤]
[¤¤¤¤¤¤¤¤]    [¤¤¤¤¤¤¤¤¤¤¤¤¤¤¤¤¤¤¤]    [¤¤¤¤¤¤¤¤¤]
[¤¤¤¤¤¤¤¤]    [¤¤¤¤¤¤¤¤¤¤¤¤¤¤¤¤¤¤¤]    [¤¤¤¤¤¤¤¤¤]
[¤¤¤¤¤¤¤¤]    [¤¤¤¤¤¤¤¤¤¤¤¤¤¤¤¤¤¤¤]    [¤¤¤¤¤¤¤¤¤]
%°°°°°°°°&    %°°°°°°°°°°°°°°°°°°°&    %°°°°°°°°°&
