§^^^^^^^^^^^^^^^^^^^^^^^^^^^^^^^^^^^^^^^^^^^^^^^^^^^^^^^^^^^$§^^^^^^^^$
[¤¤¤¤¤¤¤¤¤¤¤¤¤¤¤¤¤¤¤¤¤¤¤¤¤¤¤¤¤¤¤¤¤¤¤¤¤¤¤¤¤¤¤¤¤¤¤¤¤¤¤¤¤¤¤¤¤¤¤][¤¤¤¤¤¤¤¤]
[¤¤¤¤¤¤¤¤¤¤¤¤¤¤¤¤¤¤¤¤¤¤¤¤¤¤¤¤¤¤¤¤¤¤¤¤¤¤¤¤¤¤¤¤¤¤¤¤¤¤¤¤¤¤¤¤¤¤¤][¤¤¤¤¤¤¤¤]
[¤¤¤¤¤¤¤¤¤¤¤¤¤¤¤¤¤¤¤¤¤¤¤¤¤¤¤¤¤¤¤¤¤¤¤¤¤¤¤¤¤¤¤¤¤¤¤¤¤¤¤¤¤¤¤¤¤¤¤][¤¤¤¤¤¤¤¤]
%°°°°°°°°°°°°°°°°°°°$¤¤¤¤¤¤¤§°°°°°°°°°°°°°°°°°°°°°°°°°°°°°°°&[¤¤¤¤¤¤¤¤]
§^^^^^^^^^^^^^^^^^^$[¤¤¤¤¤¤¤]§^^^^^^^^^^^^^^^^^^^^^^^^^^^^^^^&¤¤¤¤¤¤¤¤]
[¤¤¤¤¤¤¤¤¤¤¤¤¤¤¤¤¤¤][¤¤¤¤¤¤¤][¤¤¤¤¤¤¤¤¤¤¤¤¤¤¤¤¤¤¤¤¤¤¤¤¤¤¤¤¤¤¤¤¤¤¤¤¤¤¤¤]
[¤¤¤¤¤¤¤¤¤¤¤¤¤¤¤¤¤¤][¤¤¤¤¤¤¤][¤¤¤¤¤¤¤¤¤¤¤¤¤¤¤¤¤¤¤¤¤¤¤¤¤¤¤¤¤¤¤¤¤¤¤¤¤¤¤¤]
[¤¤¤¤¤¤¤¤¤¤¤¤¤¤¤¤¤¤][¤¤¤¤¤¤¤][¤¤¤¤¤¤§°°°°°°°°°°°°°°°°°°°°°°°°°°$¤¤¤¤¤¤]
[¤¤¤¤¤¤¤¤¤¤¤¤¤¤¤¤¤¤][¤¤¤¤¤¤¤][¤¤¤¤¤¤%^^^^^^^^^^^^^^^^^^^^^^^^^^&¤¤¤¤¤¤]
[¤¤¤§°°°°°°°°°°°°°°&[¤¤¤¤¤¤¤][¤¤¤¤¤¤¤¤¤¤¤¤¤¤¤¤¤¤¤¤¤¤¤¤¤¤¤¤¤¤¤¤¤¤¤¤¤¤¤¤]
[¤¤¤]§^^^^^^^^^^^^^$[¤¤¤¤¤¤¤][¤¤¤¤¤¤¤¤¤¤¤¤¤¤¤¤¤¤¤¤¤¤¤¤¤¤¤¤¤¤¤¤¤¤¤¤¤¤¤¤]
[¤¤¤][¤¤¤¤¤¤¤¤¤¤¤¤¤][¤¤¤¤¤¤¤][¤¤¤¤¤¤¤¤¤¤¤¤¤¤¤¤¤¤¤¤¤¤¤¤¤¤¤¤¤¤¤¤¤¤¤¤¤¤¤¤]
[¤¤¤][¤¤¤¤¤¤¤¤¤¤¤¤¤][¤¤¤¤¤¤¤]%°°°°°°°°°°°°°°°°°°°°°°°°°°°°°°$¤¤¤¤¤¤¤¤¤]
[¤¤¤][¤¤¤¤¤¤¤¤¤¤¤¤¤][¤¤¤¤¤¤¤%^^^^^^^^^^^^^^^^^^^^^^^^^^^^^^^&¤¤¤¤¤¤¤¤¤]
[¤¤¤][¤¤¤¤¤¤¤¤¤¤¤¤¤][¤¤¤¤¤¤¤¤¤¤¤¤¤¤¤¤¤¤¤¤¤¤¤¤¤¤¤¤¤¤¤¤¤¤¤¤¤¤¤¤¤¤¤¤¤¤¤¤¤]
[¤¤¤][¤¤¤¤¤¤¤¤¤¤¤¤¤][¤¤¤¤¤¤¤¤¤¤¤¤¤¤¤¤¤¤¤¤¤¤¤¤¤¤¤¤¤¤¤¤¤¤¤¤¤¤¤¤¤¤¤¤¤¤¤¤¤]
[¤¤¤%&¤¤¤¤¤¤¤¤¤¤¤¤¤%&¤¤¤¤¤¤¤¤¤¤¤¤¤¤¤¤¤¤¤¤¤¤¤¤¤¤¤¤¤¤¤¤¤¤¤¤¤¤¤¤¤¤¤¤¤¤¤¤¤]
[¤¤¤¤¤¤¤¤¤¤¤¤¤¤¤¤¤¤¤¤¤¤¤¤¤¤¤¤¤¤¤¤¤¤¤¤¤¤¤¤¤¤¤¤¤¤¤¤¤¤¤¤¤¤¤¤¤¤¤¤¤¤¤¤¤¤¤¤¤]
[¤¤¤§$¤¤¤¤¤¤¤¤¤¤¤¤¤§°°°°°°°°°°°°°°°°°°°°°°°°°°°°°$¤¤¤¤¤¤¤¤¤§°°°°°°°°°°&
[¤¤¤][¤¤¤¤¤¤¤¤¤¤¤¤¤]§^^^^^^^^^^^^^^^^^^^^^^^^^^^^&¤¤¤¤¤¤¤¤¤%^^^^^^^^^^$
[¤¤¤][¤¤¤¤¤¤¤¤¤¤¤¤¤][¤¤¤¤¤¤¤¤¤¤¤¤¤¤¤¤¤¤¤¤¤¤¤¤¤¤¤¤¤¤¤¤¤¤¤¤¤¤¤¤¤¤¤¤¤¤¤¤¤]
[¤¤¤][¤¤¤¤¤¤¤¤¤¤¤¤¤][¤¤¤¤¤¤¤¤¤¤¤¤¤¤¤¤¤¤¤¤¤¤¤¤¤¤¤¤¤¤¤¤¤¤¤¤¤¤¤¤¤¤¤¤¤¤¤¤¤]
[¤¤¤][¤¤¤¤¤¤¤¤¤¤¤¤¤][¤¤¤¤¤¤¤¤¤¤¤¤¤¤¤¤¤¤¤¤¤¤¤¤¤¤¤¤¤¤¤¤¤¤¤¤¤¤¤¤¤¤¤¤¤¤¤¤¤]
[¤¤¤][¤¤¤¤¤¤¤¤¤¤¤¤¤][¤¤¤¤¤¤§°°°°°°°°°°°°°°°°°°°°°°°°°°°°°°°°$¤¤¤¤¤¤¤¤¤]
[¤¤¤][¤¤¤¤¤¤¤¤¤¤¤¤¤][¤¤¤¤¤¤]§^^^^^^^^^^^^^^^^^^^^^^^^^^^^^^$[¤¤¤¤¤¤¤¤¤]
[¤¤¤][¤¤¤¤¤¤¤¤¤¤¤¤¤][¤¤¤¤¤¤][¤¤¤¤¤¤¤¤¤¤¤¤¤¤¤¤¤¤¤¤¤¤¤¤¤¤¤¤¤¤][¤¤¤¤¤¤¤¤¤]
[¤¤¤][¤¤¤¤¤¤¤¤¤¤¤¤¤%&¤¤¤¤¤¤%&¤¤¤¤¤¤¤¤¤¤¤¤¤¤¤¤¤¤¤¤¤¤¤¤¤¤¤¤¤¤][¤¤¤¤¤¤¤¤¤]
[¤¤¤][¤¤¤¤¤¤¤¤¤¤¤¤¤¤¤¤¤¤¤¤¤¤¤¤¤¤¤¤¤¤¤¤¤¤¤¤¤¤§$¤¤¤¤¤¤¤¤¤¤¤¤¤][¤¤¤¤¤¤¤¤¤]
[¤¤¤][¤¤¤¤¤¤¤¤¤¤¤¤¤¤¤¤¤¤¤¤¤¤¤¤¤¤¤¤¤¤¤¤¤¤¤¤¤¤][¤¤¤¤¤¤§$¤¤¤¤¤][¤¤¤¤¤¤¤¤¤]
[¤¤¤][¤¤¤¤§°°°°°°°°°°°°°°°°°$¤¤¤¤¤¤¤¤¤¤¤¤¤¤¤][¤¤¤¤¤¤][¤¤¤¤¤][¤¤¤¤¤¤¤¤¤]
[¤¤¤][¤¤¤¤%^^^^^^^^^^^^^^^^$[¤¤¤¤¤¤¤¤¤¤¤¤¤¤¤][¤¤¤¤¤¤][¤¤¤¤¤][¤¤¤¤¤¤¤¤¤]
[¤¤¤][¤¤¤¤¤¤¤¤¤¤¤¤¤¤¤¤¤¤¤¤¤][¤¤¤¤¤¤¤¤¤¤¤¤¤¤¤][¤¤¤¤¤¤][¤¤T¤¤][¤¤¤¤¤¤¤¤¤]
[¤¤¤][¤¤¤¤¤¤¤¤¤¤¤¤¤¤¤¤¤¤¤¤¤][¤¤¤¤¤¤¤¤¤¤¤¤¤¤¤][¤¤¤¤¤¤][¤¤¤¤¤][¤¤¤¤¤¤¤¤¤]
%°°°&%°°°°°°°°°°°°°°°°°°°°°&[¤¤¤¤¤¤¤¤¤¤¤¤¤¤¤][¤¤¤¤¤¤][¤¤¤¤¤][¤¤¤¤¤¤¤¤¤]
§^^^^^^^^^^^^^^^^^^^^^^^^^^^&¤¤¤¤¤¤¤¤¤¤¤¤¤¤¤][¤¤¤¤¤¤][¤¤¤¤¤][¤¤¤¤¤¤¤¤¤]
[¤¤¤¤¤¤¤¤¤¤¤¤¤¤¤¤¤¤¤¤¤¤¤¤¤¤¤¤¤¤¤¤¤¤¤¤¤¤¤¤¤¤¤%&¤¤¤¤¤¤][¤¤¤¤¤][¤¤¤¤¤¤¤¤¤]
[¤¤¤¤¤¤¤¤¤¤¤¤¤¤¤¤¤¤¤¤¤¤¤¤¤¤¤¤¤¤¤¤¤¤¤¤¤¤¤¤¤¤¤¤¤¤¤¤¤¤¤%&¤¤¤¤¤][¤¤¤¤¤¤¤¤¤]
[¤¤¤¤¤¤¤¤¤¤¤¤¤¤¤¤¤¤¤¤¤¤¤¤¤¤¤¤¤¤¤¤¤¤¤¤¤¤¤¤¤¤¤¤¤¤¤¤¤¤¤¤¤¤¤¤¤¤][¤¤¤¤¤¤¤¤¤]
%°°°°°°°°°°°°°°°°°°°°°°°°°°°°°°°°°°°°°°°°°°°°°°°°°°°°°°°°°°&%°°°°°°°°°&
