H
§^^^^^^^^^^^^^^^^^^$ §^^^^^^^^^^^^^^^^^^^^^^^^^^^^^^$
[S¤¤I¤¤¤¤¤¤J¤¤¤II¤¤] [SS¤J¤¤¤I¤¤¤¤¤¤¤¤¤¤¤¤¤¤¤¤¤¤¤¤¤¤]  
[¤¤(°°°°°)¤¤¤()¤¤¤¤] %°°°°°°)¤(°°°°°°°°°°°°°°°°°°°)¤]
[¤J]§^^^^}¤¤¤][¤I¤¤{^^^^^^^^}¤{^^^^^^^$ §^^^$§^^$ [¤]
%°°&[¤¤¤¤¤¤¤¤][¤I¤¤¤¤¤¤¤¤¤¤¤¤¤¤¤¤¤¤¤¤¤] [SIS{}J¤{^}¤]
§^^^}¤¤(°°°°°&[¤II¤¤¤¤¤¤¤¤¤(°°°°°°°°)¤] [SSS¤¤¤¤¤¤¤¤]
[¤¤¤¤¤¤{^^^^^^}¤¤¤¤(°)¤(°°°&....§^^^}¤] [SS¤()¤¤(°)¤]
[¤¤¤¤¤¤¤¤¤¤¤¤¤¤¤¤¤¤].[¤]....§^$.[¤¤¤¤¤] %°°°&%°°& [¤]
%°°°°°°)¤¤(°°°°°°°°&§}¤{$. .[I].[¤(°°°&  §^$ §^$  [¤]
§^^^^^^}¤¤{^^^^^^^^$[¤¤¤]§^^}¤{^}¤].  §^^}S{^}S{^^}¤]
[J¤¤¤¤¤¤¤¤¤¤¤¤¤¤¤¤¤][¤¤¤][¤¤¤¤¤¤¤¤]   [¤JJ¤¤¤¤¤¤SSMS]
[¤M()¤¤()¤¤()¤¤()¤¤]%°°°&[¤(°°°°°°&   %°°°°°°°°°°°)S]
[¤¤{}¤¤{}¤¤{}¤¤{}¤¤{^^^^^}¤{^^^^$.                %°&
[¤¤¤¤¤¤¤¤¤¤¤¤¤¤¤¤¤¤¤¤¤¤¤¤¤¤¤¤T¤¤].
[¤¤()¤¤()¤¤()¤¤()¤¤¤¤¤¤¤¤¤¤(°°°°&.
[¤M{}¤¤{}¤¤{}¤¤{}¤¤(°°°°°°°&......
[J¤¤¤¤¤¤¤¤¤¤¤MM¤¤¤¤]..............
%°°°°°°°°°°°°°°°°°°&..............




