              $^^^^^^^^^^^^^^^^^^^&                
              [¤¤¤¤¤¤¤¤¤¤¤¤¤¤¤¤¤¤¤]               
              [¤¤¤¤¤¤¤¤¤¤¤¤¤¤¤¤¤¤¤]               
              [¤¤¤¤¤¤¤¤¤¤¤¤¤¤¤¤¤¤¤]                
              [¤¤¤¤¤¤¤¤¤T¤¤¤¤¤¤¤¤¤]               
              [¤¤¤¤¤¤¤¤¤¤¤¤¤¤¤¤¤¤¤]                 
              [¤¤¤¤¤¤¤¤¤¤¤¤¤¤¤¤¤¤¤]               
              [¤¤¤¤¤¤¤¤¤¤¤¤¤¤¤¤¤¤¤]               
              [¤¤¤¤¤¤¤¤¤¤¤¤¤¤¤¤¤¤¤]               
              [¤¤¤¤¤¤¤¤¤¤¤¤¤¤¤¤¤¤¤]               
              [¤¤¤¤¤¤¤¤¤¤¤¤¤¤¤¤¤¤¤]               
              [¤¤¤¤¤¤¤¤¤¤¤¤¤¤¤¤¤¤¤]               
              [¤¤¤¤¤¤¤¤¤¤¤¤¤¤¤¤¤¤¤]                
              [¤¤¤¤¤¤¤¤¤¤¤¤¤¤¤¤¤¤¤]               
              [¤¤¤¤¤¤¤¤¤¤¤¤¤¤¤¤¤¤¤]               
              [¤¤¤¤¤¤¤¤¤¤¤¤¤¤¤¤¤¤¤]               
              [¤¤¤¤¤¤¤¤¤¤¤¤¤¤¤¤¤¤¤]                 
§^^^^^^^^^^^^^&¤¤¤¤¤¤¤¤¤¤¤¤¤¤¤¤¤¤¤%^^^^^^^^^^^^^^$
[¤¤¤¤¤¤¤¤¤¤¤¤¤¤¤¤¤¤¤¤¤¤¤¤¤¤¤¤¤¤¤¤¤¤¤¤¤¤¤¤¤¤¤¤¤¤¤¤]
[¤¤¤¤¤¤¤¤¤¤¤¤¤¤¤¤¤¤¤¤¤¤¤¤¤¤¤¤¤¤¤¤¤¤¤¤¤¤¤¤¤¤¤¤¤¤¤¤]
[¤¤¤¤¤¤¤¤¤¤¤¤¤¤¤¤¤¤¤¤¤¤¤¤¤¤¤¤¤¤¤¤¤¤¤¤¤¤¤¤¤¤¤¤¤¤¤¤]
[¤¤¤¤¤¤¤¤¤¤¤¤¤¤¤¤¤¤¤¤¤¤¤¤¤¤¤¤¤¤¤¤¤¤¤¤¤¤¤¤¤¤¤¤¤¤¤¤]
[¤¤¤¤¤¤¤¤¤¤¤¤¤¤¤¤¤¤¤¤¤¤¤¤¤¤¤¤¤¤¤¤¤¤¤¤¤¤¤¤¤¤¤¤¤¤¤¤]
[¤¤¤¤¤¤¤¤¤¤¤¤¤¤¤¤¤¤¤¤¤¤¤¤¤¤¤¤¤¤¤¤¤¤¤¤¤¤¤¤¤¤¤¤¤¤¤¤]
[¤¤¤¤¤¤¤¤§^^^^$¤¤¤¤¤¤¤¤¤¤¤¤¤¤¤¤¤¤¤§^^^^$¤¤¤¤¤¤¤¤¤]
[¤¤¤¤¤¤¤¤]    [¤¤¤¤¤¤¤¤¤¤¤¤¤¤¤¤¤¤¤]    [¤¤¤¤¤¤¤¤¤]
[¤¤¤¤¤¤¤¤]    [¤¤¤¤¤¤¤¤¤¤¤¤¤¤¤¤¤¤¤]    [¤¤¤¤¤¤¤¤¤]
[¤¤¤¤¤¤¤¤]    [¤¤¤¤¤¤¤¤¤¤¤¤¤¤¤¤¤¤¤]    [¤¤¤¤¤¤¤¤¤]
[¤¤¤¤¤¤¤¤]    [¤¤¤¤¤¤¤¤¤¤¤¤¤¤¤¤¤¤¤]    [¤¤¤¤¤¤¤¤¤]
%°°°°°°°°&    %°°°°°°°°°°°°°°°°°°°&    %°°°°°°°°°&
